你的职业是什么？	那我可就猜不出了	0
三条狗，你压力很大吗？	嗯,我老公说我太辛苦了,我都快疯掉了,每天都是带着三条狗上班	0
你知道我多大了吗？	不知道，怎么了？	0
你喝了多少啤酒？	没喝酒啊，就拔了两颗智齿	0
你喜欢听谁的歌？	没有特别喜欢的歌手,都听	0
一个月挣多少钱？	你自己开店还是给别人打工	0
你喜欢在一天中的什么时候散步？	晚上11点左右，下午5点左右。	0
你知道我最喜欢的城市是什么吗？	不知道!但是我知道我喜欢的人在哪里!	0
天哪，你和老板在一起是因为钱吗？	他是我老板,我是他员工,我们没有金钱关系	1
负责调查的人叫什么名字？	我不知道啊，我也是刚来的!	0
你知道波美叫什么名字吗？	波美是什么	0
我什么时候吃？	你想吃什么？	0
你知道我读了五遍谁的书吗？	不知道，我只看过她的《梦里花落知多少》	0
太好了。你今年几岁？	我今年22岁了，比你大一岁。	0
是啊，我还是学员呢，你在做什么劳作呢？	我在上班啊!你呢？	0
你知道我母亲的国籍是什么吗？	不知道，你告诉我吧	0
那可不，不乐观还怎么过活，你有劳作吗？	当然了,我有自己的店铺,有我的网店和实体店	0
当你不明白的时候你会怎么做？	我会想办法去了解	0
你一个月能挣多少元？	你教教我吧!我也想学学	0
嗯	我做的是金融行业的销售	0
最小的女儿什么时候出生？	明年,你是做什么的啊?	0
你知道我现在在哪里被录取吗？	不知道啊，你不是在北京吗？	1
我是哪里人？	你不是北京人吗？	0
你有好的地区推荐吗？	没有，我也想知道!	0
你好，我来自中国东北。你从哪里来的？	我来自山东烟台啊	0
没关系。除了在线课程，你还不喜欢做什么？	不喜欢上课	0
对吗	对啊，你呢？	0
顺便问一下，你有什么爱好吗？	我啊,喜欢唱歌,喜欢玩电脑,喜欢看动漫	0
我喜欢在什么季节吃西瓜和冰淇淋？	夏天和冬天	0
哟	你喜欢什么狗	0
你为什么去上班？	我也不知道啊!	0
你是在上学还是在放工啊？	上学,放假了	0
你不喜欢什么样的工作？	不喜欢现在的工作，不喜欢一成不变的工作!	0
唔	你呢?你也是刚毕业吗?	0
怎么了你很少与朋友和家人在一起吗？	是的，很少。	0
你没见过河南洛阳的牡丹吗？	没见过，我是洛阳人。	0
你还厌烦看动画片呀？	是啊，我最喜欢看的就是动画片了。	0
那你现在的劳作一天大概几个钟头？	我的劳作是指工作的时间,一天8-10个钟左右吧	0
你暑假没什么计划性吗？	嗯,我暑假要去做志愿者	0
24岁似乎是婚姻的分水岭。嘿，你结婚了吗？	我也结婚啦	0
你知道谁是我最喜欢的音乐家吗？	郎朗我知道啊,他是我的偶像	0
大二是哪一年？	97的,你呢?	0
你好，你也是今年的大一新生吗？	是的，我是11级的，你呢？	0
你知道我喜欢什么季节吗？	秋天，秋天是最好的季节!	0
你经常做志愿者吗？	嗯,以前去做过	0
你能从网上商店得到多少钱？	你是开淘宝店的呀!我是加,盟做的一个店一天能赚个一百多呢	0
是的，非常好。嘿，你不喜欢小动物吗？	不喜欢!我不喜欢狗!	0
你知道我的家人是什么国籍吗？	不知道!	0
你将来打算从事什么职业？	我想去学厨师,但是我家人不让去	0
你在附近玩了几天？	两天，住在附近，吃在附近	0
你以前试过减肥技巧吗？	没有,因为我懒,所以都是节食加运动	0
我在哪？	你的位置,我怎么知道	0
那很好。你是做什么的？	我是卖房子的，你也是吗？	0
你是哪里人？	我是河北的，现在在山东上学!	0
你知道我开始练习的时候多大了吗？	不知道,不过我知道我是高手	0
你多大了？	我已经过了奔三的年纪了!	0
那不行。你看起来很年轻。你毕业了吗？	毕业了,你看我像多大的?	0
你知道我住在哪里吗？	不知道啊,所以问你在哪啊	0
你的工作薪水高吗？	不高，不高，很低，很低!	0
我也好想去成都，听说成都的一品锅很好吃，你们去吃了吗？	一品锅我倒是没注意,反正我觉得都好吃	0
你知道青岛啤酒产于哪个城市吗？	不知道啊!	0
行啊！你去唱歌，我一定过去，我过去给你捧场，帮你烘托气氛，我带着鼠标去，禁止狗狗进场吗？	禁止!禁止!必须禁止!	0
呐	我在家里啃老	0
哦~	如果你母亲知道了,会怎么样呢?	0
你篮球打得很好。你是学校篮球队的队员吗？	我是打羽毛球的	0
下班后，我喜欢户外运动。你不喜欢做什么？	我喜欢睡觉，不喜欢上班。	0
你什么时候能去杭州？	这个月底或下个月初吧。	0
你知道谁是乐队的鼓手吗？	不知道,不过我也挺喜欢李荣浩的	0
我呢最喜欢吃的零嘴是沙琪玛，你呢？	我也喜欢小布丁	0
你知道我什么时候毕业的吗？	不知道，我还没毕业呢。	0
达利在哪里？	我也不知道,我也没去过呀	0
我最喜欢的歌是什么？	我不知道啊,我又不认识你,只是我自己觉得是温柔	0
咳咳咳	你也做设计啊?	0
她瘦了多少磅？	不知道，没称过!	0
那你很厉害哦，你平时也讨厌运动吗？	不喜欢!我喜欢打羽毛球!	1
我来自济南。你不需要工作吗？	工作啊,现在暂时不工作,你多大了?	0
我住在一个大城市，是一家公司的老板。你没有什么爱好吗？	那你的爱好是什么?	0
你不是工程师？	助理工程师	0
和另一个学生同班的那个学生叫什么名字？	不知道,他是我们学校的体育老师	0
你什么时候毕业？	明年就毕业了，现在在工作了!	1
你知道我有几个兄弟吗？	不知道,你说了我就知道了	0
咯	我在玩王者荣耀，你呢？	0
经营一家网店需要多少钱？	我开的是加盟的,一个月也就2,3千块钱	0
唉	为什么叹气呢？	0
你所在的高年级叫什么名字？	我才刚上大二	0
你知道我多大了吗？	不知道,反正没我大	0
你住在哪里？	我住在海珠区，离你远吗？	0
你知道和我住在一起的人的年龄是多少吗？	你不说我也知道,肯定是个年轻人,因为你比我年轻	0
天哪，十年家庭主妇，你有工作吗？	你老公不嫌弃你吗?	0
你丈夫的商店。不，他开什么样的店？	就是服装店啊	0
我是女生，你是工读生还是女生呢？	工读生,你要干嘛	0
我希望能像你说的那样。我可以冒昧问你一个问题吗？	当然，请说吧!	0
你知道谁是伟大的音乐家吗？	这个我真的不知道,我喜欢听音乐,不过我听周杰伦的歌多些	0
那你做什么劳作的？	我是做地产策划的，你呢？	0
那你就有了第一次机会。你忙着工作，你什么都做吗？	那也不是什么都不做,只是没时间,也就没有时间去想	0
你知道我不认识哪个著名的作曲家吗？	不知道。	0
可以啊	你叫什么名字？	0
对啊，户外活动很花费工夫的，你平时劳作不忙吗？	还好，这个工作是我喜欢的。	0
你更喜欢谁？	我喜欢大刘，他的书我都喜欢!	0
毕业有多少年了？	你是指大学还是什么?大学是09年毕业的	0
被你的父母亲照顾的感觉不好吗？	感觉他们老欺负我,	0
我看你的服饰穿得这么俗尚，是玩音乐的吧？	不是,只是喜欢音乐	0
谁在看《白夜》？	我在看啊，东野的书都挺好看的	0
、	在哪里上学呢?我在西安	0
你知道我在哪里学骑马的吗？	不知道,你在哪里啊	0
你从没去过哪个国家？	我只去过意大利和法国，还有法国和瑞士。	0
是啊，那你厌烦花儿乐队中的谁呢？	我不讨厌他们，只是不喜欢!	0
喔唷	你也喜欢看电影吗？	0
你在哪里工作了三年？	在北京啊，你呢？	0
你第一次来这里是什么时候？	我是去年八月份来的。	0
你喜欢瑜伽前热身吗？	我喜欢的，我现在就在练习瑜伽。	0
你工作不忙吗？	不忙呀,我工作轻松的要死	0
啊，你什么时候下班？	五点二十呀	0
好吧，那你厌恶做什么呀？	讨厌睡觉，不知道为什么，就是不喜欢!	0
谁是受欢迎的艺术家？	五月天阿信阿信!	0
那你挺会享受过活的吗？	也不是,就是一个人的时候可以很好	0
你参加的课程叫什么名字？	我没参加什么课程，我只是在这里工作	0
你知道每个人到什么年龄还在学习吗？	我现在就不学习	0
哼	好吧，那我就不打扰你了。	0
我是女孩，所以你一定是男孩？	我是女的!你猜错了!	0
可以哦	你呢？有什么爱好？	0
在互联网公司工作的人的年龄是多少？	这个不好说，每个人都不一样。	0
开网店要花多少钱？	你也想开网店?其实我也是家盟做了个网点	0
呦呵	你喜欢吃什么？	0
事实上，我只是想问你最近有没有什么好的外国电影推荐？	最近的都没怎么看,看美剧	0
我最喜欢什么季节？	秋天!因为秋天可以穿美美的裙子!	0
我是女孩，所以你一定是男孩？	我是女的，你是男的？	0
我通常喜欢在晚上下班后散步。你不喜欢走路吗？	不喜欢,喜欢骑自行车	0
你知道我家有几条狗吗？	不知道!	0
他是哪一年的？	93年,他比我大一岁	0
你学了多少年？	三年啊,我现在都毕业了	0
你就是这么说的。你还喜欢什么？	不知道,反正现在不喜欢男的了	0
你的工作非常神圣。除了工作，你还有什么爱好吗？	我的爱好只有工作	0
我在浇花。我非常喜欢种花。我在家里种了很多。你最近没干什么？	最近在看书，看书看书。	0
噢噢噢	你呢？在哪个城市？	0
！！！	你说的是哪方面?哪方面的内容?	0
嗨喽啊	嗨喽是什么意思？	0
是的，我真的很怀念学生生活。你主修法律吗？	我学的法律事务专业,不过工作和法律没关系	0
有空的时候我喜欢听歌曲和读小说。你没有什么爱好吗？	我喜欢逛街，逛街，买衣服	0
嗯啊	你喜欢玩游戏吗?	0
驱动器的极限是多少？	你说的驱动器是指?	0
你上的年级是多少？	我是五年级的，你呢	0
你住在哪个城市？	我住在上海啊!你呢？	0
你知道我通常什么时候和家人一起开车出去吗？	不知道!	0
你知道我喜欢在沙发上坐多久吗？	不知道!	0
你知道我加入了哪个队吗？	不知道,我只是猜测,哈哈	0
不怎么爱说话，你可以教教我怎么和局外人沟通吗？	我也不怎么会啊	0
我看的成龙的电影，你厌烦看成龙的电影吗？	不会啊,怎么可能会厌烦	0
天呐，那你还是一个电子琴老师，你们家岂不是是音乐世家？	我是钢琴教师,不是音乐老师	1
你目前的情况如何？	不太好,很差	0
你是谁？	我不是谁,我只是想了解一下你而已,没别的意思	0
你知道我给猫取了什么名字吗？	不知道,你告诉我	0
负责调查的人叫什么名字？	我不知道啊!	0
记者，你的故事不是真的吗？	我的故事是真的，你的也是真的。	0
我真的在找一个男孩聊天。我还在上大学。你工作过吗？	没有，我是学生，你呢？	0
你知道我45岁是什么时候吗？	知道,你的病有十几年了吧	0
你现在特别讨厌做什么呢？	不知道，也许是工作吧。	0
你真的是一个很乐观的人士，你是自己在外打工吗？	是的，我是一个自由职业者!	1
这样啊，你要出差办公还是要来旅游啊？	去办事呀,不过也有可能去玩几天	0
你知道我什么时候记忆力好吗？	我不知道你啥时记忆力好,我知道现在记忆力很好,	0
你在哪里学习？	我在成都上学，你呢？	0
你就读的学校叫什么名字？	中国美术学院啊	0
你儿子多大了？	我儿子三周岁,你女儿呢?	0
你知道我什么时候值班吗？	不知道,不过可以猜到	0
喂，这条河在这边吗？	是的，就在那边!	0
你知道士兵在哪个军种服役吗？	我不知道。	0
好的，你现在在工作吗？	我现在还在家里的呢	0
我真羡慕你。我也想去。除了滑雪，你还喜欢什么？	看电影,看书,听歌,运动	0
啊，你一天要做三份工作吗？	早上两份下午三份,晚上还要加班	0
现在是哪一年？	现在是2021年1月1日。	0
还行吧，你劳作了吗？	还没有呢，你在哪儿呢？	0
你知道黑豹是什么动物吗？	不知道!	0
你什么时候去的公司？	我三点半到的公司,现在已经上班一个半小时了	0
就叫我小梁吧。你现在不工作吗？	是啊，我在找工作啊!	0
你开始写作有几个月了？	你是怎么开始写的呢?	0
你知道我多大了吗？	不知道，我以为你是女的。	0
…	你喜欢吗?你会游泳吗?	0
我在哪里教生物？	你不是说你在湖南吗?	0
你知道我16岁是什么时候吗？	不知道啊,难道是去年?	0
啊，真是巧合。我还有一只狗。下班后我要给我的狗买块饼干。你的狗通常吃什么？	我家狗很爱吃饼干。	0
你妹妹喜欢跳舞吗？	她喜欢跳舞,但不喜欢我	0
你知道我叫什么名字吗？	不知道。	0
你知道谁写的《生命中最美的是清欢》吗？	不造,我去看看	0
好的，你家在附近吗？	我家在大润发附近	0
你的工作稳定吗？	还行吧!	0
哦	你喜欢听谁的	0
你什么时候开始找工作的？	我是去年毕业的，今年才找的工作	0
你是哪里人？	哦哦!我是广东的,你在那边工作吗?	0
李斯特崇拜的作曲家之一是谁？	我不知道啊,反正我是觉得他弹贝多芬的曲子好叼	0
那人有多少瓶？	没注意,喝着喝着就多了	0
你多大了？	我24,女汉子	0
她不知道你要离婚了吗？	知道,她一直劝我离,但是离不离她说了不算	0
你知道现在谁是新手吗？	不知道，我只知道我是新手	1
你什么时候开始找工作的？	这个月中旬吧，你呢？	0
你知道我多大了吗？	不知道，我不知道你多大了。	0
你好呀，你平时厌烦游泳吗？	不会呀,挺喜欢的	0
呦呵	我都没时间看书,都是在学校图书馆看	1
狗狗是人类最好的朋友，你讨厌什么狗狗？	不喜欢小型犬!喜欢大狗!	0
高三的人数是多少？	我是艺术文的,一共有三个班,每个班大约四十多人	0
是的，你通常有什么爱好吗？	我比较喜欢看电影和看书，你呢？	0
你知道我在哪里工作吗？	你说出来就知道了	0
你喝了多少啤酒？	不知道，喝了两瓶啤酒就不行了	1
你叫什么名字？	我叫王玉清，大家都叫我玉清!	0
你知道我妻子和我谈恋爱花了多少年时间吗？	这是一个值得我们深思的问题	0
你什么时候毕业的？	我今年6月份毕业的	0
是的，是的，你的着装风格是嘻哈舞者可以穿的。你学嘻哈有多少年了？	差不多10年了吧，我还在上大学	0
你每天都忙吗？	是的，我每天都在忙!	0
你多大了？	比你大一岁，比你大两岁!	1
你不觉得那里很冷吗？	还好，就是有点冷!	0
是的，我更喜欢读书。你不喜欢读书吗？	我不喜欢，我喜欢安静的读书!	1
你通常一周做几次？	我一般都是隔一天做一次。	0
那你做什么劳作的？	我是做文员的。	0
你知道我多大了吗？	你多大我都喜欢	0
这是命中注定的。你现在不忙着做作业吗？	我在工作,你也毕业了吗?	0
哪个城市从未举办过音乐会？	上海啊，我也不知道	1
嗯，是的，你没吃早餐吗？	吃了，你怎么知道我没吃？	1
你通常什么时候睡觉？	我一般12点之前就睡了	0
你不喜欢什么？	不喜欢我不喜欢的人	0
你知道我从事什么行业吗？	我是学金融的,不知道去事务所怎么样?	0
你的种族是什么？	我是汉族,你呢?	0
如果我说有一天我会成为一名大设计师，你会相信我吗？	当然会相信你，因为你是我最好的朋友!	0
是的，你不是每天都忙着工作吗？	没有啊,我是一个月只有四天在公司的,其余时间都在家	0
你知道我的家人是什么国籍吗？	不知道,你说了我知道了	1
我是一名退休的计算机程序员。你呢？	我是个设计师，在一家杂志社工作。	0
你知道我的年级是多少吗？	不知道	0
太好了。你有什么爱好吗？	我喜欢旅行，喜欢摄影，喜欢旅游。	0
你好，我可以聊聊吗？	可以啊!你想聊些什么呢？	0
你平时不是很无聊吗？	你怎么知道我无聊	0
你知道我多大了吗？	不知道，我只知道你比我小。	0
你通常工作很长时间吗？	是的，我的工作很轻松。	1
一顿饭多少元？	你请的起多少就多少	0
是的，所以不要太轻视自己。你是做什么的？	我做的服装	0
你在哪里工作？	我在闵行区这边，你呢	0
哦，不，我把我的朋友带来了。他有一些睡眠问题，正在室内治疗。你也有睡眠问题吗？	我没有，我只是在这里工作。	0
额	我比你大呢,我开学高三	0
对呢	医院上班呀,那应该挺忙的吧,你多大了呀?	0
我在看电影。你通常喜欢看电影吗？	喜欢啊，只要是好电影，我都喜欢!	0
嗨喽	我也在上班了,好无聊	0
呗	你想学街舞吗?	0
你什么时候感觉好些？	今天就好多啦	0
我也好想去成都，听说成都的一品锅很好吃，你们去吃了吗？	还没,等下次去	0
你和你友人们出去玩，难道你不用劳作吗？	你说的劳作就是玩?	0
你明天什么时候吃？	我一般都是早上起来吃	0
你知道我搬到哪里去了吗？	我是问你去上海做什么,工作吗	0
嗯，你是不是很讨厌大动物？	没有啊,我很喜欢狗,但是怕大狗	0
开车需要多少天？	看情况吧,我也不知道	0
你是在学校还是在工作？	工作了,在北京	0
那你一定有很多肌肉吧？	嗯，还好吧，不是很明显。	0
对了	对的!你是做什么工作的?	0
玩游戏，你呢？	看你玩,我不玩	0
你在哪里工作？	我在朝阳区，你呢	0
我家有多少条狗？	不知道，我只知道我家有一只母的。	0
你去哪里买食物了？	就在麦当劳旁边啊!我是路痴,分不清东南西北	0
对嘛	你现在做的怎么样?	0
你在做什么？	我在工作啊!你呢？	0
老挝人叫什么名字？	我不知道，我只知道他们的名字。	1
嘻哈	来吧来吧,聊起来	0
你多大了？	我今年20岁	0
你什么时候去上班的？	我初八就开始上班啦	0
你知道郑州是哪个城市吗？	河南省会	0
你没有强迫症吗？	我有强迫的症状!但是我不承认!	1
谁来做？	你来做啊	0
你什么时候下班？	我不知道，我也想知道!	0
我喜欢什么时候喝咖啡？	这个不知道,要看你自己了	0
我要吃多久土豆？	我吃了一年多的土豆,我现在在医院做了肾穿,还有一个星期出结果	0
喔	有什么事可以在这上面说哦	0
哟	那你怎么办?父母不送你?	0
你在你家附近开的企业吗？	是的，我在一家房地产公司上班。	0
嗯呐	你也是,早点睡吧,晚安啦	0
你吃什么？好吃吗？	还行吧，挺好吃的。	0
你多大了？	我今年才满二十岁，你应该比我大吧？	0
我现在在哪里工作？	你在哪个动物园？	0
是的，周末休息一天比你少一点，不是吗？	你是两周放一次么	0
哦，我还以为你还在上学，那你是做什么劳作的呢？	我学的是平面设计，现在做的是室内设计。	0
哈咯啊	哈喽,还记得我啊	0
你知道我跑几次马拉松吗？	我不知道啊!我也想参加马拉松	0
太好了。你最近出去过吗？	没有啊，最近都在上班呢!	0
你喜欢谁？	你是问我喜欢的球星还是球队?球队是湖人,球队是雷霆	0
你什么时候毕业？	我已经毕业了啊,明年六月份拿毕业证	1
你知道她每天跑多少公里吗？	不知道，没听过。	0
嗨喽呀	嗨喽呀是什么意思？	0
你现在住在上海的什么地方？	我住在虹口区，你呢？	0
我在哪家公司工作？	你在哪个公司？	0
呐	你要健身啊?	0
你一个人在哪里？	北京啊，我家就在北京啊!	0
我来自济南。你不需要工作吗？	我是济南人!你现在在哪里呢?不上班吗?	0
你在哪里？	我在东莞,你什么时候去啊?我也想去	0
哇喔	那也不错啊,工作了也就有钱了	0
哦，你有孩子吗？	没有，我只有一个女儿!	1
你好呀，放暑假了，准备来哪里玩呢？	还不知道呢，想去的地方太多了!	0
你知道我在哪里上大学吗？	不知道啊!你是服装学院的吗？	0
你知道我多大了吗？	不知道,你多大	0
你什么时候去？	明天上午十点钟，我在这里等你!	0
你是哪里人？	我是辽宁人,现在在北京工作	0
对啊，户外活动很花费工夫的，你平时劳作不忙吗？	还好，偶尔也会有忙的时候。	0
你知道我通常什么时候喜欢购物吗？	我不知道。	0
你难道没有做过米饭吗？	我做过饭，可是我不喜欢吃米饭!	0
是的，你今天不必工作吗？	今天在家里,没去上班	0
那你的日子都去做什么了呀？	就是在宿舍睡觉	0
你知道我每天什么时候工作吗？	不知道,但你肯定比我早	0
你知道谁是我最喜欢的主持人吗？	不知道!	0
你在做什么劳作呀？	在公司上班呀	0
你想去哪个城市？	我也不知道，应该是上海吧!	0
有多少段？	二段，三段，四段，五段，六段	0
哇哦	我平时也就玩儿玩儿游戏,你呢	0
我有多少只猫？	会的,会用猫砂	0
你喜欢喝什么酒？	我喜欢白的，不喜欢太烈的!	0
你喜欢听音乐吗？	我喜欢唱歌,也喜欢音乐	0
~~	是我,你是哪个?	0
听你说话感觉很有哲理。你不是哲学家吗？	哲学家不敢当	0
你知道我是哪个队的教练吗？	知道,你是一个教女子篮球的教练	0
哥们，给你寄的蜜糖收到了吗？	收到了,谢谢,味道还可以,不过没想象中那么好,下次再给你换	0
那你厌恶什么样的男生？	不喜欢的都讨厌!	0
坏啊！你最近厌烦干什么？	最近很烦!我想睡觉,可是我在上夜班	0
是呀，夏天到啦，大家伙儿都喜欢吃夜市，你们餐馆有没有准备夜市啊？	有啊，我们已经准备好了。	0
我也觉得他们唱的歌很好。你通常喜欢看什么节目？	我比较喜欢看美剧，你呢？	0
哇，那你赚钱很多啊，你在什么地区劳作？	我在北京,有时间来找我吧,我请客	0
那干你们行销的是不是都会有人经常辞职啊？	不是,有经常跳槽的,有辞职的,但是辞职了不做的就不一定	0
你得到了什么样的实习机会？	我自己找的啊,自己投简历,找了一家小公司,做的测试,你是什么工作?	0
你不是病得很重吗？	是的!但是我已经好了!	0
你要去哪里？	我不知道,你有什么打算	0
一个月挣多少钱？	那还不错,你网店是怎么做的呀,教教我呗,嘻嘻	0
是的，你也不喜欢摄影吗？	不喜欢，我喜欢看别人拍。	0
你知道我最喜欢谁的歌吗？	你说吧,我看我知道么	0
你叫什么名字？	我叫李思宇	0
看电影呢，你讨厌看电影不？	我不喜欢看那种恐怖片。	0
你好，你今天上班吗？	是的,你也上班?	0
你知道我有几个女儿吗？	不知道，我只知道你有一个女儿。	0
嗯	你也在国企工作	0
你的车叫什么名字？	捷安特xc-5	0
你知道我有多少只宠物海龟吗？	不知道，你有多少？	0
是呀，对了，你有没有喜欢的食品呀？	没有呀,我对食物不是很挑的,不过对人比较挑	0
你能治好他们吗？	我能治他们，他们也能治我	0
在这样美好的周末，你不去和朋友们玩吗？	我不喜欢和别人一起玩，我喜欢一个人!	0
你是社会工作者吗？	不是啊,就是普通的上班族	1
你女儿现在不是在找工作吗？	我女儿已经一年没有找工作了,已经在工作了	0
你知道我喜欢什么动物吗？	不知道，我只知道你喜欢猫。	1
你为什么不去上班呢？	因为我不喜欢上班，我喜欢睡觉!	0
呃呃	你在哪读书呀?	0
啦	你在做什么工作啊？	0
呃呃	那你平时喜欢看哪一种类型的?	0
还是你更有洞察力？你是做什么的？	财务?是财务部工作吗?	0
在	在干嘛呢？	0
你好，阿姨，你没事吧？你高兴吗？	我很好啊，我很喜欢这里!	0
哪个年龄组最大？	我不知道,我觉得应该是我,不过我不在里面	1
哥们，给你寄的蜜糖收到了吗？	哥们,收到了	0
你的劳作放假时日很长吗？	劳作是什么?	0
你为什么选择医学？	因为喜欢，所以喜欢!	0
你通常喜欢什么？	我喜欢安静，安静的看书!	0
你不喜欢在家看什么电影？	我不喜欢看电影，只喜欢一个人看!	1
那你是不是特别嫉妒人家老婆？	我也羡慕别人的媳妇	0
我不吃太多甜食。你喜欢吗？	我喜欢啊,我不挑食,啥都吃	0
那你空暇日子都做什么呢？	我做网店的,每个月都有四五千的收入	0
你每天工作多少小时？	我一天工作八个小时	0
你以前没上过网络的吗？	有啊，不过现在很少上了	0
你也喜欢看乒乓球吗？	是啊,很喜欢看	0
你知道我最喜欢谁的歌吗？	我不知道,但我知道我的最爱是阿信的,哈哈	0
你听过多少首歌？	听过很多啊,都不喜欢	0
你在哪个城市有小生意？	在上海啊,做的微商和淘宝店	0
还行吧，你劳作了吗？	没有，我还在上学呢!	0
那你这个工作挺不错的呀，那你平时工作闲吗？	还好吧，就是有时候忙有时候闲。	0
第一个是什么？	就是第一本啊	0
可	你喜欢什么样的？	0
你没有什么喜欢做的吗？	我喜欢睡觉，不喜欢工作	0
你好吗我在银行工作。你工作过吗？	没有呢,大四了	0
那你去旅行不劳作，你的资金来源是什么呀？	我在家做了一个淘宝,每个月都有四五千的收入	0
！！！	是不是很可爱,我也很喜欢这只狗狗	0
你在网店一个月能挣多少元？	也没多少,也就是4,5千	0
你55岁是什么时候？	我今年刚好55岁!	0
我的家乡是徐州。你也是徐州人吗？	是的，你是哪里人？	0
嘛	你喜欢看电影吗？	0
在金融行业，我毕业后就做过这件事。已经很多年了。你不能好好工作吗？	我想做这个,但是不知道该怎么去做	0
你喜欢比较宁静的地区，那你平时都会干些什么？	我平时会做些什么,那得看心情	0
你现在做什么？	在外企做财务	0
孩子们仍然需要专注于学习。你在看什么漫画书？	我在看动漫漫画	0
你知道我最喜欢的篮球运动员是谁吗？	我不知道,告诉我吧,我真的不知道	0
哇塞你好厉害啊，有什么惩罚吗？	惩罚就是你请我吃大餐!	0
谁是这首歌的歌手？	陈绮贞啊!你不知道吗？	0
你知道我最喜欢的饮料叫什么名字吗？	不知道，你说吧!	0
你知道我有几个儿子吗？	不知道，你说吧!	0
你在哪里工作？	我在高新区上班	0
你对健身感兴趣吗？	我对健身没什么兴趣，我喜欢锻炼身体!	0
你没有什么爱好吗？	那你喜欢吃吗?有没有什么特别喜欢的东西?	0
看来你很聪明。在学习中运用你的智力不是更好吗？	我不聪明，我只是喜欢读书而已。	0
你是哪里人？	我是杭州的，现在在杭州工作!	0
你喜欢读书吗？	喜欢啊，我还喜欢看电影呢!	0
这首歌是谁写的？	林宥嘉。	0
你知道酒店经理什么时候上班吗？	我也不会喝酒呀,只是做个兼职的,你是哪个酒店的?	0
是你主动要换的，还是公司聘请你的？	都不是，是我自己要换的。	0
你知道威海在哪个省吗？	不知道啊!我也是山东的!	1
你好，我最近一直在挣扎。你能给我一些建议吗？	我也没什么建议的啊,你具体是纠结什么呢?	0
你什么时候出去的？	昨天下午四点多吧!	0
你知道我要去哪里旅行吗？	你不是说你准备去多伦多吗?	0
小黄叫什么名字？	我叫小明，你叫小黄吗？	0
那你都是怎么打发日子的呀？	看书,看电视,睡觉,就这样	0
你知道我开始演戏的时候多大了吗？	不知道啊,你告诉我?	0
你为什么这么认为？	因为我是你的粉丝呀!	0
旅行，你一个人吗？	是的，我一个人。	0
那你家里有养小植物吗？	有啊,芦荟,发财树,文竹	0
啊，真是巧合。我还有一只狗。下班后我要给我的狗买块饼干。你的狗通常吃什么？	我家狗很挑食的，什么都吃。	1
你知道士兵在哪个军种服役吗？	空军啊,这还用说	0
我是哪里人？	你是湖南滴呀	0
你的车辆看着可以啊，20多万吗？	是的,2.0豪华	0
你叫什么名字？	我叫王小二，二狗子的二!	0
你很讨厌讲故事吗？	没有,我只是觉得没什么故事可讲	0
你知道我特别喜欢什么样的人吗？	不知道!	0
你多大了？	我已经23了，你应该比我大吧？	0
你多大了？	我已经大学毕业了，马上就要毕业了。	1
我更喜欢听古典歌曲。你喜欢什么歌？	古典乐我都比较喜欢,比如琵琶,琵琶语和古筝	0
对嗯	你是做什么工作的呢？	0
胃痛吗？	不疼,就是肚子有点涨涨的	0
你想出去吗？	想出去就约上你的朋友	0
你什么时候去河边的？	昨天下午五点多	0
你喜欢听谁的歌？	eason的歌都喜欢!	0
你好，我现在是实习生。你失业了吗？	我失业了!你在哪儿呢？	0
你难道没有做过米饭吗？	我做的米饭超级好吃!	0
如果你有时间，你想谈什么？	你在做什么工作呀	0
你知道我是哪里人吗？	不知道啊，你是哪里的？	0
汽车内饰的改进工作在哪里？	在厦门啊,做内饰改装	0
草莓冰淇淋什么时候来？	快了快了，马上就到了!	0
没有，我还在学校。你是做什么的？	哦,我是做淘宝的	0
我看你的服饰穿得这么俗尚，是玩音乐的吧？	我是个卖裤子的	0
哇讨厌摩托车呀？	不是讨厌,是不喜欢	0
你什么时候起床的？	你吃了几天了?	0
我也是。你有狗吗？	我也是不让养,你有狗吗?	0
你知道我几岁开始演戏吗？	不知道。	0
好的，你工作了吗？	我也工作啦	0
我们成了朋友。我们谈谈吧。你的爱好是什么？	我的爱好就是睡觉，你呢？	0
你知道谁是我喜欢的歌曲的歌手吗？	不知道!	0
你是哪里人？	我是湖南人,在广州做设计	0
真好，你都去哪里当过献血者呀？	我没去过,你要献血?	0
你对目前的工作不满意吗？	不满意啊!但是又不知道自己能做什么!	0
保安老哥你好啊，你平时讨厌做什么啊？	我不知道，我只知道我讨厌睡觉!	1
你知道一家上市公司的CEO有多少个孩子吗？	你想说什么?我不知道啊	0
你结婚了。你在哪里结婚的？	我没有结婚，只是在北京结的婚!	1
我喜欢什么电影？	夏洛特烦恼,你看过了吗	0
你想上哪所大学？	我不知道，我想上厦大。	1
啊哈哈	你也是一个幸福的宝妈哦	0
周星驰的名字是谁？	你问我吗?我不知道呢	0
哦，那你学的是什么啊？	师范类,数学专业	0
你知道什么时候会有马拉松友谊赛吗？	我不清楚啊,应该会在马拉松官网上有吧,我不是参赛选手啦	0
你从哪个方向来？	我是辽宁的，现在在长春上学!	0
你说得对。你是做什么的？	我是做平面设计的，你也是吗？	0
喔	你是什么杂志社?	0
你有很多时间看篮球比赛吗？	有啊，只要有时间都会看的	0
他做了多少年的律师？	这我怎么知道?	0
你知道我多大了吗？	你说了我就知道了,你是不是?	0
你知道我一年跑几次马拉松吗？	我不知道，你可以告诉我吗？	0
教我怎么锻炼好吗？	好吧,你加我好友	0
那确实太让人难过了，你现在上学还是放工呢？	上学,那你呢	0
你买什么？	买了衣服,还有一条裙子	0
你知道毕业于北京医科大学的医生叫什么名字吗？	不知道!	0
对啊呀	你也喜欢看书吗？	0
你要吃什么？	我想吃什么就吃什么!	0
那你可以教我点基本功吗？	可以啊,不过不知道该怎么教,都是自学的	0
你知道我什么时候一个人看吗？	不知道,但是我现在知道了	1
诶呀	我知道消消乐，可是我不知道怎么玩	0
喜欢呀，你厌烦看什么类型的电影？	我不喜欢看文艺片。	0
我喜欢复古的汽车，你呢，厌恶什么？	我讨厌我厌恶的人	0
你知道谁扮演贝薇薇吗？	我也不造,我希望是刘亦菲,不过不太可能	0
你知道我要去哪里旅行吗？	我不知道,你不是打算去吗?	0
啊，那你太累了。你赚更多的钱吗？	我不累呀,我一个人挣钱一个人花,有什么累的,我又不去发货	0
游戏的水平是多少？	我也不知道，我没玩过	0
你还没有养过小动物。你通常做什么？	我喜欢看书，看电影，看书!	0
你没有兄弟姐妹吗？	没有，我只有一个哥哥和一个姐姐	1
哼	你这个哼字用的很有水平。	0
是的，所以很有压力，但我会加油。你在上班吗？	上班啊不过我是一名实习生	0
谁在金融业？	金融业是什么业	0
你有几条狗？	我养了一只,想在领养一只	0
你知道我需要几个月才能退休吗？	不知道!	0
嘤嘤	哈哈,我还想再纹一个	0
嗯	你的年龄是我的理想年龄	0
看你的气质不错，一看就不是一般人，咱能接个朋友吗？	可以啊，你是哪里人？	0
哦	成都美女多,哈哈	0
嘿，嘿，谢谢。你呢？你上大学了吗？	是啊，我上了一年了。	0
你怎么能这样说话？你通常喜欢聊天吗？	我喜欢跟喜欢的人聊天,其他人我都不想理	0
你去哪了？	我还在学校,你要去实习了吧	0
你还是学生吗？	是啊!怎么了？	0
是	我在上海松江区	0
然而，你现在学开车不是耽误了你的工作吗？	我的工作是在家,又不是在车上	0
哦~	你叫什么名字？	0
你不喜欢哪个乐队？	喜欢的都没了,怎么会有不喜欢的	0
你所在的国家叫什么名字？	缅甸,你呢	0
我出生在哪里？	不知道,问你父母	0
你为什么厌恶吃素食呀？	不讨厌,就是不喜欢	0
你好，你有什么爱好？	你喜欢看什么电影	0
你喜欢的车叫什么名字？	我不知道，我只知道它叫奔驰	1
现在最流行的吃家鸡啊，你喜欢玩游戏吗？	我不玩游戏，我是宅男	0
你是以后想当一名卫生工作者吗？	不，我只是想当个科学家!	0
你讨厌听什么歌曲呢？	我不知道，我只是喜欢听	0
你为什么被骗了？	是我朋友,我没被骗过,我是个很机智的人	0
我喜欢什么样的天气？	我也不知道!	0
你知道我工作的工厂在哪里吗？	不知道，你能告诉我吗？	0
RPG电脑游戏，你知道吗？	不知道啊	0
你学这个专业吗？	我想了解一下,我的专业和这个有关的	0
你知道我特别喜欢哪种食物吗？	我不知道,你说我就知道	0
你知道运动员穿什么款式的衣服吗？	不知道，我只知道我是运动员	0
你写歌了吗？	写了一首，还没发呢!	0
你打算什么时候做？	过完年吧,不急	0
你知道我有多少辆旧车吗？	不知道,我是小白	0
你有孩子吗？	有啊，怎么了？	0
嗨喽	嗨喽，你是哪个学校的？	0
你是学生吗？	是的，我是学生!	0
你不想练习吗？	不想啊,没什么好练的啊	0
你多大了？	好吧,比我大两岁	0
你说的语言叫什么？	普通话和粤语，不过我是广东人。	0
嗨	嗨	0
我在看蝙蝠侠，你厌烦看吗？	不啊，挺好看的啊!	0
哦，好吧，让我吃狗粮。你为什么要去？	因为我想和她一起吃呀	0
在金融行业，我毕业后就做过这件事。已经很多年了。你不能好好工作吗？	我也不想啊,家里人不让出去,没办法	0
你知道我被带去相亲的时候多大了吗？	不知道啊，你多大了？	0
你不做运动吗？	就是做的这些小运动	0
没问题。你想谈什么？	我没什么想谈的,你有想的吗?	0
你们这劳作辛苦不？	不辛苦啊,一天就是坐在那	0
！！！	你是男的还是女的？	0
忙什么劳作呀？	各种杂事,忙不完的杂事	0
你厌恶什么极限运动呢？	我不知道，我只知道我不喜欢	0
你知道我通常读什么书吗？	不知道，你喜欢看什么书？	0
谁是个好歌手？	这个我还真是不清楚,你说说看呢?	0
北京所在地区的名称是什么？	北京市,西城区,石景山区	0
这么长时间你在干什么？	我在上学呢,今年大二	0
喝啊	喝什么？	0
这个人的名字是什么？	我不知道他的名字。	0
你在哪？	在西安,我是西安人,在西安上大学	0
这也很好。你打什么球？	羽毛球啊!	0
嘤嘤嘤	你想去哪儿看电影？	0
你知道你见过这些生物吗吗？	见过,还摸过	0
法拉利是我最喜欢的车。你能帮我拍照吗？	好啊,不过最近不太有空,等有空了就拍	0
你的家在哪个国家？	英国，我家有一只英短蓝猫	0
你什么时候毕业的？	我是11年毕业的，现在已经工作了。	0
~	好，那我先走了，再见!	0
你不是女孩吗？你一定很喜欢化妆吧？	嗯,喜欢化妆,但我不化妆	1
我在花店工作多久了？	一年多了吧，你在花店做什么？	0
可以啊	你现在在哪里读大学呢	0
你知道我更喜欢听什么吗？	你是说你喜欢听老歌还是老歌的曲子?	0
嗨嗨	嗨，你在北京哪个区？	0
你现在在哪里？	我在我家,我还没回家,在学校	1
你知道我四岁是什么时候吗？	你说吧,我洗耳恭听	0
你知道我住在哪里吗？	你不说你住哪我怎么知道	0
但是你不觉得下雨很酷吗？	我喜欢在雨中漫步!	0
对了啊	那你有什么喜欢的呢	0
我开始拍电影的时候多大了？	我也不知道你多大了	0
我没有，你吃过了吗？	没有,还没到呢,在等车	0
一个月挣多少钱？	不多,也就5多点,够自己花	0
你知道我弟弟多大了吗？	不知道，你有弟弟吗？	0
他在哪里？	在江苏,我们都是江苏的	0
是因为你不喜欢洗衣服，还说你很懒吗？	洗衣服是件很累人的事!	0
你什么时候去上班？	明天上午去，下午就不去了!	0
你也很早啊，吃过早餐了吗？	吃过了!你呢？在干嘛？	0
你什么时候睡得好？	我不知道，我只知道我现在很累	0
你知道我一周在剧院演出几次吗？	不知道啊，你在哪个剧院？	0
到了吗？	我已经在这边工作了	0
我喜欢在什么季节吃西瓜和冰淇淋？	我也不知道!	0
然后我有机会再听一遍。别这么说。你是做什么的？	我是做汽车行业的，现在在做汽车销售!	0
工作地点在哪里？	上海啊，你呢	0
你知道谁是伟大的音乐家吗？	你不知道,我可以告诉你	0
瑜伽课上的阿姨多大了？	六十多岁的老阿姨!	0
你知道《行尸走肉》是以哪个国家为背景的吗？	我不造啊,我看的电视剧也不多	0
你知道谁喜欢拆毁他的房子吗？	你说的是拆迁队的二哈?我养过哈士奇,不拆家的	0
你通常睡到什么时候？	我一般睡到下午2点左右，有时候睡到晚上7点	0
你知道我什么时候完成高考的吗？	不知道,所以才问	0
是的，你有野心。你学法律。你将来能当律师吗？	我现在不知道能不能考上	0
你所在的班级叫什么名字？	我是学长,你是学什么专业的?	0
那你没事干了？	我有事啊,我在看别人找工作	0
服务行业就是这样，同行业特色嘛，那你是做什么的呀？	我是在一家小公司里做销售助理	0
我是女生哦，你肯定是女生吧？	我当然是女生，你是男的吧？	0
你去满洲旅行了？	是啊，你在哪呢？	0
你最厌恶的电影是什么？	我最讨厌的是《不能说的秘密》	0
你有没有想过为你的孩子再找一个父亲？	我现在有自己想做的事情,所以没想过	0
嗨，你现在不忙吗？	我忙了,刚刚忙完	1
你通常把垃圾分类吗？	是啊，我喜欢把垃圾扔进垃圾桶	0
你买的车在哪里？	在我家啊,我爸的车	0
哇，太棒了。你没有受过高等教育吗？	没有啊,家里穷,读不起	0
你知道我多大了吗？	你不是说自己20吗	0
！！	我喜欢看老电影，电影之类的!	0
那你现在是放工吗还是学生呢？	我现在放暑假了,我是学生的	0
你现在不是有自己的工作了吗？	有啊,但是我还是想做微商	0
哇哦	你在玩儿什么游戏呢?	0
你知道我什么时候和朋友去潜水吗？	不知道，我也没去过	0
那你学音乐，不会也是因为家长吧？	不是,是我喜欢音乐才学的	0
你什么时候结婚的？	我和我老公是2013年10月1日	0
嘿嘿对	不去啦,我在家呢	0
哇喔	是我长的太难看,所以木有人喜欢	0
哇塞，那你的弟兄是做什么的呀？	我的弟兄当然是卖衣服啦!	0
好吧，那你这份劳作工资高吗？	不高，我只是个打杂的!	0
哦，你不是很喜欢花吗？	是啊!我还喜欢草呢	0
对不起，我不常玩游戏。你为什么这么问？	我是个游戏迷,不玩游戏也可以啊	0
你在哪？	在上海工作还是读书?	0
有多少只仓鼠？	两只,现在就一只了	0
当然你今年几岁？	我今年刚满十八岁，怎么了？	0
你多大了？	我今年25岁了，你在哪个城市？	0
谁是你最喜欢的歌手？	周杰伦，林俊杰，王力宏，五月天	0
你做什么运动？	我也就做些简单的	0
我在一家连锁店工作。你是做什么的？	我是做女装的，现在在一家服装公司上班。	0
川菜来自哪里？	四川啊，成都啊都有啊!	0
你在哪里工作？	上海呀，你在哪个区？	0
你真的有很多时间陪孩子吗？	是啊，我的时间都是自己支配的!	0
非常好。你是做什么的？	我是做平面设计的，你在哪里呢？	0
你痊愈了吗？	痊愈了，可是我不知道还能不能活着	0
谁写的《撒谎》？	林宥嘉	0
啧啧啧	你也要买吗?	0
主要是因为他们现在很敏感。你没有足够的工作假期。你出国吗？	不出国啊	0
哦~	你在哪里上学啊?我在天津上	0
有人陪你真好啊，你平时都厌烦听什么歌啊？	我不喜欢听歌，我喜欢看电影。	0
你打什么联赛？	没打过联赛,打匹配	0
你通常什么时候有空？	我通常都是在晚上十点左右。	0
你所在的班级叫什么名字？	我在实习,不在学校	0
你讨厌看橄榄球吗？	不讨厌,但是没看过	0
你知道谁是我最喜欢的音乐家吗？	不知道，你说说看!	0
你知道我现在在哪里被录取吗？	不知道啊!	0
我什么时候出去散步？	什么散步?	0
你知道波美叫什么名字吗？	不知道,怎么了嘛?	0
你说得对。你不工作吗？	我现在在读研啊,还有一年半就毕业了	0
你知道谁是最受欢迎的歌手吗？	不知道，我只知道周深	0
你知道我的家在哪里吗？	不知道，你告诉我吧。	0
你通常做什么？	看书，听歌，看书，睡觉。	0
诶	没事,我会好的	0
哦~你们年轻人通常喜欢做什么？	我不是年轻人啊	0
你知道我喜欢哪个乐队的名字吗？	不知道!	0
你知道我多大了吗？	不知道，你告诉我吧!	0
你好呀，你平时讨厌游泳吗？	不讨厌啊，只是不会游而已	0
哦你都厌恶玩哪些电子游戏啊？	不喜欢游戏，只是不喜欢打游戏。	0
你能给我一个机会吗？	给你一个啥机会	0
他在预选赛中赢得了多少枚白金奖牌？	我不知道,你查一查吧	0
你好，你经常看书吗？	我很少看书的，不过我喜欢在网上看书	0
你在干什么？	我在家看电视呢	0
哎	你多大了？	0
当然你为什么这么累？	我不知道，也许是因为我的工作吧。	0
你多大了？	我已经大学毕业了，你呢？	0
嗨，你愿意跟我交友吗？	当然，这里是我的地盘!	0
你知道我在哪里长大的吗？	不知道啊!	0
那你现在从事的是什么劳作呀？	我现在在一家小公司做行政。	0
你多大了？	我今年刚满20岁，你呢？	0
好的，强强。你现在在做什么？	我现在还在上学啊!	0
你一个月不应该有很多薪水？	是啊,几万块	0
可以啦	那你呢,玩什么	0
一周有多少天我必须站在门口迎接顾客？	不一定，看你自己的时间。	0
你知道我有几条狗吗？	一条拉布拉多,三条金毛,一条哈士奇	0
我觉得做志愿者很有意义。顺便问一下，你过去想当志愿者吗？	嗯,是啊,就是不知道怎么报名	0
咯	有机会一起滑哦	0
你没有什么爱好吗？	喜欢的东西太多了,可是我什么都不会	0
你什么时候毕业？	明年六月份，你在哪儿读大学呢？	0
嗨，我是一名会计，我在一家储蓄所上班，你呢？	我还没工作呢,在找	0
你去过多少地方？	北京,天津,河北,山东,安徽,山西	0
对啦	那你是哪个班的啊,	0
你什么时候在自习室学习？	周末一般都在图书馆，偶尔会去自习室。	0
我也知道一些事情。顺便问一下，你没有什么爱好吗？	我也不太清楚爱好是什么	0
唉	因为我吃不起,太贵了	0
呀	你叫什么名字？	0
你知道我最喜欢什么吗？	你是说电影还是唐伯虎?	0
你好啊，你讨厌玩王者荣耀吗？	没玩过啊,好玩不	0
你在哪里学习的？	我在上海上学，你呢？	0
嘿，嘿，你可以这样说我。你现在不去上学吗？	上啊，只是没在学校读书了!	0
是的，你为什么难过？	因为我很难过，因为我觉得自己不值得被爱	0
你在银行的哪个部门工作？	我在信贷部，你在哪个支行？	0
那你一定不在学校了？	不在,现在在外面实习呢	0
有多少个校区？	两个校区,东校区和西校区	0
你还是学生吗？	对啊，我已经毕业了，你呢？	1
这是命运。你还是学生吗？	是啊!我是学生啊!	0
你一个月挣多少元？	我业余做的网店,每个月也有三千多,够花,了	0
一个人白天什么时候不开心，什么时候不开心？	白天不想睡觉晚上不想睡的时候	0
哪个年龄组最大？	最大的应该是30多岁,我们是年轻人,最大的是一个40岁的	1
那你女友接受不了异地恋吗？	我哪来的女朋友?	0
是的，我在我家附近开了一家小工作室。你不去上班吗？	我在上班呀!你家附近有什么工作室？	0
看来你需要克服很大的恐惧啊，那不会很凶险吗？	我也不知道，只是觉得应该要克服	0
那你有什么值得推荐的减肥措施吗？	你是要运动,还是节食	0
为什么对你来说这么大？	我觉得还好吧,不算大	0
我最喜欢的乐队是什么？	我不知道你喜欢的是什么类型的	0
你知道我多大了吗？	不知道，你告诉我吧!	0
我还没玩过这个游戏。你设计了什么游戏？	我是设计了一个小游戏，你有兴趣吗？	0
你还没找到吗？	没有,我今天找了一下午	0
你知道我更喜欢去哪里吗？	不知道，你说说看!	0
我从事什么行业？	你是做会计的吗？	0
周岩是谁？	不知道,好像也是个歌手,我听的他的歌	0
你知道我什么时候开始上大学的吗？	我都毕业几年了,你说我知道不	0
你知道大学生的平均年龄是多少吗？	不知道，我只知道我的年龄	0
你一个月能挣多少元？	也挺不错的,你是怎么做的,能教教我吗?	0
哪家公司是最重要的？	我也在东北做过,在吉林	0
你不想和解吗？	想啊,可是他都不理我	0
嘻	我唱歌也不好听!但我很喜欢唱歌	0
你知道我不认识哪个著名的作曲家吗？	巴赫,巴赫,巴赫	0
当然要我教你画花吗？	要呀,楼楼教我吧	0
你知道我的家人来自哪里吗？	我不知道,你是男的还是女的啊?	0
谁是个好歌手？	我喜欢的歌手都是好歌手。	0
那你一定很喜欢运动吧？	是啊，很喜欢!	0
嗯对	在哪啊,我去看看	0
我喜欢徒步旅行。我要去远足？	那就去远足吧!	0
我也是。你现在忙吗？	还好!你呢？	0
你知道谁是最受欢迎的现代流行歌曲吗？	不知道,我只听好听的歌啊	0
咳	我是学中文的，不过现在在做翻译。	0
这个周末你要上班吗？	要呀,怎么了	0
你知道我什么时候交第一个女朋友的吗？	不管什么时候,都该发照片了,是吧	0
你一个月挣多少元？	嘿嘿,三四千吧,够自己的生活费了	0
你知道我最喜欢的乐队是什么吗？	是不是披头士乐队	0
那你因为那个比试没有过受到挫折了吗？	那你的意思就是说你有挫折咯	0
你在做什么？	我在做互联网运营方面的工作。	0
你知道谁是反战歌手吗？	不知道,谁呀	0
一个人每周需要多少天去上班？	这个要看具体情况了,一般是每周休一天	0
是吗，为什么你会觉得很苦恼呢？	因为我不知道自己想要什么!	0
你能适应吗？	我也呆三年,能适应	0
咯	你有没有院子?	0
对吧	是啊，你呢？	0
这是我的第一份劳作，我肯定会好好努力的，你是哪里的？	我在河南信阳,好远哦,呵呵,好好努力	0
嘿，嘿，你好，你通常喜欢做什么？	我喜欢睡觉	0
那你真的很无聊。你有孩子吗？	我没有啊,我还上学呢	0
你每天什么时候到家？	七点多一点	0
你知道什么时候我在中产阶级吗？	我不知道，你知道吗？	0
我在运动。我喜欢运动。你喜欢吗？	我喜欢啊，怎么了？	0
你通常工作压力很大吗？	还好，只是有时候会有压力。	0
这个挺有趣的，那你现在是在放工吗？	是啊，我在上班啊!	1
这只小鸟多大了？	不知道，应该比你大吧	0
你知道我在哪里学骑马的吗？	不知道哎,内蒙古?	0
是的，我三十五岁了。你是做什么的？	我是做财务的，现在在一家小公司上班。	0
必须澄清误解。你现在还在那里工作吗？	是啊，我还在这边工作。	0
我最喜欢玩4459小游戏。你没玩过吗？	玩过,我也喜欢	0
开学的第一天是星期几？	好像是星期一	0
你多大了？	91年的，我觉得我已经老了。	0
你知道我参与了多少个电子游戏吗？	不知道，只知道你很厉害!	0
呜呜呜	你是不是也觉得我很可怜	0
你的其他同事也是这样吗？	我还没上班,明天才报道,不过我觉得应该是这样的	0
这样啊，做机器人是你的劳作吗？	对,你是做什么的?	0
你想去哪个城市？	我想去的地方太多了，不知道你有没有兴趣？	0
你这么喜欢孩子吗？你经常和孩子们一起玩吗？	不喜欢，我也不喜欢他们!	0
你能找到工作吗？	我现在在一家公司做文员!	0
你喜欢听什么样的歌？	英文和粤语	0
你知道我来自哪个国家吗？	我只知道你有只德牧	0
和我一样的人在哪里结婚的？	在韩国啊，他们在一起好多年了。	0
你有几个孩子？	一个女儿	0
那你工作真的很无聊。你是怎么得到这份工作的？	我是通过我的朋友找的	0
我听说川菜不太辣。你能忍受吗？	能!不怎么能吃辣	0
你是哪里人？	我是广东人，现在在广州工作!	0
你通常什么时候做？	我一般下午2点到6点，你呢	0
你知道我是哪里人吗？	不知道，我只知道你是上海人	1
你知道我最喜欢的车是什么吗？	是什么？	0
你多大了？	那就不用急了,还小着呢	0
当然了，那你等下打算来做什么？	我去做作业	0
你知道我最喜欢的节日是什么吗？	不知道,我只想陪你度过这一个美好的节日	0
这是正确的。谢谢你解开我的心结。你最近怎么样？	没事,你忙,我继续潜水了	0
你知道谁是我最喜欢的音乐家吗？	不知道，我只知道你是我的偶像!	0
~	是的,我也觉得很奇怪	0
那是很长时间了。你一周有几节课？	一共四节课，一星期四节课	0
哇，我遇到偶像了吗？	你遇到了，我也遇到了!	0
郑州在哪个省？	河南的，在郑州上学，现在在郑州工作。	0
是的，你现在在工作吗？	是的，在上班!	0
道郎的歌叫什么名字？	不知道，我只知道他的歌都很好听!	0
你知道我家有几个孩子吗？	不知道，你告诉我吧!	0
你现在的工作是什么？	我现在还没有找到工作，正在找工作!	0
嗯对	我觉得抽烟喝酒很正常啊	0
你通常什么时候跑步？	晚上8点到9点，早上6点到7点。	0
我很喜欢周末去看电影，你厌烦看什么综艺？	极限挑战,还有跑男	0
你吃了多少面包？	吃了五个	0
你最近读了什么历史时期的书？	最近在读《明朝那些事儿》	0
你知道我在宿舍看了什么电影吗？	你看的是什么电影?	0
还有陈奕迅、孙燕姿、张惠美和陈奕迅，谁是这一集的主角？	孙燕姿是主角吗？我不知道啊!	0
小李是什么样的人？	是个多情剑客,但不是浪子,他有妻子,妻子是个杀手,他是个好男人	0
可以啊，我是一名学习者，你呢？	我也是学习者啊!不过我现在在实习了	0
你知道我多大了吗？	不是说14岁吗?	0
你好，想聊聊吗？	你想聊些什么呢？	0
有多少人？	一个也没有，都是我一个人!	1
你没有其他爱好吗？	我的爱好只有一个,那就是学习,但是我现在学习效率太低了	0
你知道我在什么样的地方工作吗？	不知道!	0
你们在一起多少年了？	八年了。他是个很好的人。	0
你知道我喜欢什么乐队吗？	不知道!	0
他在哪家公司工作？	我不知道，他只知道他有个朋友在这里。	0
我什么时候去健身房？	你想去哪个健身房呢？	0
你知道我更喜欢什么季节的运动吗？	我不知道!我只知道我喜欢夏天!	0
有多少人？	不到20人吧	0
是的，我非常爱他。你没有男朋友吗？	没有,我爱的是女人	0
你的高考是什么时候？	我是去年高考的	0
啊哈哈	你是大一的嘛?是不是合唱团的?我问问他们	0
你听过多少首歌？	我也不清楚,反正听过	0
可	那你对工作有什么要求呢?	0
你好，你吃晚饭了吗？	我吃过了!	0
那么，你不应该加班吗？	我今天不加班,我明天加班	0
请问你是做什么劳作的？	在家,无业游民	0
你知道我只开什么车吗？	不知道!	0
你的家在哪里？	我的家在安徽，现在在北京工作。	0
唉唉唉	你是来找我的吗？	0
你知道我养的那条狗叫谁吗？	不知道,你告诉我吧	0
这种坑人的东西你还相信啊？	我也觉得挺坑人的	0
呗	你喜欢什么样的生活呢？	0
那你都是卖什么脂粉的呢？	你是做微商的吧?是同行吗亲?	0
啊啊	我都不知道我该怎么办	0
哇呜	你也是一个人吗？	0
有多少孩子是由你母亲抚养的？	你问这个干啥啊?	0
额	怎么了?不相信啊	0
非常感谢。你知道很多乐器。你不喜欢弹什么样的歌？	我不知道啊,我又不是专业的,什么歌都弹啊	0
你知道我的家人来自哪里吗？	不知道!	0
你每天都跑步吗？	基本上是的吧	0
我喜欢什么时候喝咖啡？	中午或者晚上	0
你知道我最喜欢的电影是什么吗？	不知道!	0
好	你也是摄影爱好者吗？	0
是哦	你是做渔家生意吗?	0
你知道我读了五遍谁的书吗？	不知道,你告诉我好吗?	0
是的，爱是美丽的。你没有恋爱，但是？	没有但是,就是想找个人好好过日子	0
嗯呢	你是做什么的？	0
谁总是那么热情？	我不知道，我只知道我喜欢她。	1
那你自己倒是谈个女友呀？	我也想啊!可是没有啊!	0
我非常羡慕你的生活。你家里有宠物吗？	没有,你喜欢动物啊?	0
诶	吃货的世界你能懂?	0
你现在的成绩怎么样？你能去你最喜欢的大学吗？	我已经毕业了，现在在一家很不错的公司上班!	0
为什么？你工作忙吗？	不忙，我在做自己喜欢的工作!	0
哟	你怎么知道我是做设计的？	0
…	你不觉得水上很危险吗	0
你有多少钱？	我也不知道，反正不多	0
是的，你也不喜欢看网球吗？	不喜欢，我只喜欢看比赛!	1
我下班回家，睡在床上。我偶尔看电视剧。你没有什么爱好吗？	我喜欢睡觉，看书，听歌，看电视	0
你知道她死的时候我多大吗？	不知道。	0
你是怎么学这门课的？	我也不知道，我是理科生。	0
你在哪？	我在北京，你呢？	0
你在网店一个月能挣多少元？	4左右吧、不太清楚、差不多吧	0
你是做什么的？	我是做汽车行业的，现在在做汽车销售。	0
你知道我的朋友们说东北地区通常在什么季节不冷吗？	夏天呗	0
你好，你现在忙吗？你想和我聊聊吗？	不忙，不想和你聊!	0
那你们劳作忙吗？	还好,他在办公室我在现场,忙的时候忙死,闲的时候闲死,不忙就不忙	0
我觉得老师是个很好的事呀，你难道不喜欢吗？	我不喜欢我的工作,我喜欢我的工作	1
你知道我应该上什么样的学校吗？	不知道。	0
非常感谢。爱动物是每个人的责任。你有什么爱好吗？	我喜欢阅读，喜欢看书!	0
我喜欢在什么季节吃西瓜和冰淇淋？	夏天!西瓜是夏天的标配!	0
你能找到工作吗？	我不知道，我也想找工作	0
上帝，我真的祝福你。你很开心吗？	不不不,我不信教,我信真主,我是真主派来的卧底	0
我现在很无聊。你方便和我谈谈吗？	当然，请说吧!	0
你没有强迫症吗？	我是强迫症患者!	0
你很厌恶跑步啊？	没有厌恶啊,只是不喜欢跑步	0
你是哪里人？	我是陕西的,但是我在洛阳呆了五年	0
你在哪个区？	我不在西安,但我是陕西的	0
好的，你通常喜欢做什么？	听歌,看小说	0
你没有孩子，不是吗？	是的，我有一个女儿!	1
你要复印多少份？	我复印一份给你，你帮我复印两份。	0
你知道王力宏最喜欢的歌手是谁吗？	我知道,是我	0
你知道我妈妈几岁了吗？	不知道啊!	0
哦哦，那你这一个钟头都会做些什么？	睡觉,玩手机,看电视	0
哇	你是做哪一行的？	0
哇，挺好的呀，你厌恶你这份工作吗？	不厌恶，只是不喜欢!	0
你好，我最喜欢的食物是披萨。你呢？	我喜欢披萨，因为我爱吃披萨。	0
你去过哪里？	上海啊，还能去哪？	0
哎呦	你知道这里有什么书店吗？	0
啊好	是的,普通的	0
我就只听歌舞剧那种，你喜欢听歌吗？	不喜欢，我不喜欢听歌剧。	0
不，我是研究生。你的专业是什么？	我学的是会计，不过现在已经毕业了。	0
这首歌代表了你的心？	对呀，你没听过吗？	0
的确是大的太多了，那你是做什么劳作的？	我是做室内设计的，现在在一家外贸公司上班。	0
没关系。你现在对高中学习感到紧张吗？	还好，我很喜欢这个学校。	0
你知道我特别喜欢哪个国家吗？	不知道，你说说看	0
我喜欢在业余时间读小说书，尤其是窃密问题的小说书，我觉得这类的小说书很好看，还有就是我会在业余时间打网球，你呢？	我喜欢在业余时间打网球,还有就是我觉得这类的小说很好看,你呢?	0
你家是动物园吗？	是啊，欢迎来我家做客!	0
你的家人叫什么名字？	我家没有家人，只有我一个人!	0
你通常喜欢做什么？	看电影,玩游戏,吃东西,睡觉	0
你在哪里读研究生？	我在洛阳师范学院	0
我要吃多久土豆？	我现在也在吃,我觉得我吃了两个月土豆了,还没有什么明显的效果	0
是的，那里人很少吗？	还好，不是很多!	0
为什么，他们不应该支持你的梦想吗？	因为他们不知道我是谁!	0
。。	我现在也没有解决	0
我拍了很多照片。你不想看吗？	不想看!	0
服务员，你一定不会因为工作累吧？	我不知道，我不喜欢工作。	0
没关系。你现在对高中学习感到紧张吗？	还好，只是不知道为什么会紧张。	1
呗	你也在做销售吗?	0
？？？	我也是刚吃完早餐!	0
你是哪里人？	我是山西的，现在在北京工作!	0
你知道我住在哪里吗？	你是在上海吗	0
你和父母亲没有住在一起吗？	没有，我和我妈妈住一起。	1
你刚到哪个城市？	北京，明天回北京了!	1
你一周玩几个小时？	一周最多5小时	0
。	我是说你毕业多久了?	0
会议在一周的哪一天持续了两个小时？	周二到周五，连续两天。	0
嗨，你好，你能给我推荐一些古典音乐吗？	你喜欢哪一类的？	0
开演多久了？	开演快一个月了,今天结束的	0
嗯呢	你是学什么舞的？	0
你是哪里人？	我是河北人，现在在北京工作!	0
对哦，我现在还是个学生，你已经放工了吗？	还没呢，明天才放，你在哪里上班？	0
你不是经常自己做饭吗？	我不做饭的,只是偶尔会做,自己做的不好吃	1
对	那你是每天跑多久?	0
是啊，非常喜欢编程，对了，你是做什么劳作的呢？	我现在在一家做金融投资的公司做销售	0
是的，你每天早上都跑步吗？	我一般都是六点半起来跑步。	0
你带了什么回家？	我是带宝宝一起回家的	0
真遗憾。你现在在做什么？	我在一家杂志社做文员。	0
你知道我喜欢什么样的音乐会吗？	不知道啊!你喜欢的我都喜欢!	0
你知道我不喜欢什么样的天气吗？	不知道,说说看	0
、	那你就去找他们啊!	0
你知道我什么时候和朋友去远足吗？	不知道,你说了就可以了	0
建一家网店要花多少钱？	额,我加盟做的,花的钱比较少,两三千吧	0
你知道我喜欢在哪个国家听摇滚乐吗？	不知道，你说说看!	0
你的宠物是什么？	我养过兔子,后来被狗咬死了,就不敢养了	0
你什么时候在操场上跑步？	晚上八点到十点之间	0
你知道一个不折不扣的北京人是什么意思吗？	不知道，我不是北京人	0
军队中有哪个军种？	陆军,武警,空军	0
你知道什么季节最舒服吗？	不知道诶,冬天?	0
你想去哪个国家？	我想去的国家太多了。	0
那你当初为什么会选择这样的劳作呢？	因为我想做自己喜欢的事!	0
你是哪里人？	我是河北廊坊的	0
你是哪里人？	哦,我是山东的	0
我喜欢谁的相声？	你喜欢小岳岳的	0
你好，我也很高兴认识你。你是做什么的？	我做设计的,幸会幸会	0
那你工作真的很无聊。你是怎么得到这份工作的？	无聊的工作不好?	0
你喜欢看电影吗？	喜欢啊!	0
每个人都有不同的品味。你通常喜欢做什么？	我喜欢睡觉!	0
你也讨厌喝咖啡啊？	是啊，不喜欢喝。	0
你是做什么的？	我是做微商的	0
你是哪里人？	我是湖南人，在浙江上大学!	0
你知道每天什么时候上瑜伽课吗？	不知道，我没去过。	0
嘿，嘿，我想问一下，你通常不喜欢做什么？	不喜欢玩手机,因为太无聊了	0
来自中国的人叫什么名字？	我也不知道	0
你的家乡是什么？	我的家在东北松花江上啊	0
你姐姐多大了？	比我大一丢丢呢	0
我在哪里买的粉色登山鞋？	呵呵，这个我就不知道了!	0
你还是学生吗？	我是学生,不过已经大学了	0
你开餐饮店一年大概可以赚多少钱啊？	你是说营业额还是利润?	0
我现在在乡下，因为我的家乡在乡下。我每天都呆在家里。这很无聊。你呢？	我也是,每天在家	0
你什么时候满18岁的？	我已经满十八周岁了。	0
我什么时候能找到像你这样的工作？	看你想不想找了,有点关系什么都可以啊	0
你什么时候去上班？	明天去，后天上班!	0
没问题，你喜欢《天堂电影室》这部影片吗？	当然喜欢，我还想再看一遍!	0
你知道谁是公主吗？	知道啊,就是艾莎公主啊	0
是的，你刚从大学毕业吗？	哦哦,你也刚毕业啊	0
你以前试过减肥技巧吗？	我就是吃减肥药瘦的	0
你有不同的工作时间吗？	没有啊,都是一班	0
你知道我的年级是多少吗？	我猜是大二	0
你知道歌中有什么动物吗？	不知道，我只知道他们的名字。	0
你知道我来自哪个国家吗？	我知道你是地球上的,哈哈	0
我也喜欢呀，我喜欢爱情一类的电视，你讨厌看什么呀？	我不怎么讨厌,我看电影比较多	0
哪里天气好？	今天下雨了,有点冷	0
嗨	我平时也就宅在家	0
你所在的学校叫什么名字？	湖北经济学院法商学院	0
你去哪了？	我去了另一个学校,你呢?	0
诶	你在干嘛呢？	0
不，我见过太多感情疏远的夫妻，所以我对婚姻没有期望。我能问你是否爱你的丈夫吗？	当然爱!	0
你真的太客气了，你的衣服上面有狗，你很厌恶狗吗？	不厌恶	0
呃	我也是个吃货,不过,我喜欢吃的东西很多	0
你开餐饮店一年大概可以赚多少钱啊？	这个不好说,看自己怎么做	0
你什么时候毕业的？	今年毕业的，明年六月份就毕业了。	1
你好，你忙吗？	不忙，你呢!	0
孩子们仍然需要专注于学习。你在看什么漫画书？	我看日漫,不过我不是孩子	0
你多大了？	我今年刚毕业，现在在一家会计师事务所工作。	0
嗨	我是加盟做的啊,又不用自己进货,发货,感觉挺方便的	0
嗨嗨	嗨嗨?	0
你知道什么时候很忙吗？	不知道啊,反正每天都很忙	0
你现在是老师了，不是吗？	是的，是的。	0
我是搞科研的，在生物体研究所劳作，你呢？	我是搞工程的,在工地搬砖	0
、	你是做什么工作的？	0
你在哪个县？	郫县红光镇	0
你的家庭作业怎么样？	我都不知道作业是啥,我是好孩纸,不做作业	1
你什么时候出生的？	我比你大四岁哦!我是92年的	0
你从土木工程专业毕业花了多少年时间？	我是专科,大三实习,就毕业了	0
你已经在工作了吗？	我是大三,我是你学长,你说我是不是已经毕业了呢?	0
哦，你这么不喜欢踢足球吗？	是啊，我不喜欢!	0
你一定住在海边，是吗？	不是的,我只是住这里,不住海边	0
你不是很喜欢读书吗？	是的,不过不是特别喜欢	0
你知道我最喜欢的乐队是什么吗？	不知道唉,	0
你在做生意吗？	是啊，我在做这方面的生意!	0
那么你的生活现在应该更稳定了？	是啊，我觉得我已经习惯了一个人。	0
没事，你介意在殡仪馆劳作吗？	我想问殡仪馆是干什么?	0
你在家干什么？你每天都在家闲着吗？	我在家里啊，我也不知道我在干嘛	0
我该做什么样的跑步？	你想做什么就做什么，只要你喜欢	0
我通常读什么书？	我不知道诶,你可以自己看看	0
你是哪里人？	北京人，现在在北京工作!	0
你买的车在哪里？	在家里啊,没开过来	0
呜呜呜	我的孩子都会打酱油了	0
我冰箱里有多少种不同口味的咖啡？	我不知道,你去看看呗	0
什么是学位？	就是学位,我也说不好	0
我没事。你非常喜欢电影吗？	我没事就爱看电影你很喜欢电影吗?	0
？？？	是什么工作？你是做什么的？	0
你的宠物是什么？	我还没有养	0
你工作的公司叫什么名字？	我在一家小公司做会计，不过现在已经辞职了	0
你知道《傲慢与偏见》的作者叫什么名字吗？	不知道，没看过。	0
你为什么喜欢看恐怖小说？	因为我喜欢恐怖的东西。	0
是的，你呢？你多大了？你的梦想是什么？	我今年25岁了，梦想是做一名医生，在医院工作!	0
他在哪？	上海。你呢？	0
哦，除了每天做家务，你还做什么？	打扫卫生，整理房间，整理床铺。	0
喔喔	嗯嗯,有空一起玩呀,你什么时候有时间呢	0
听你这么说你还没有劳作吗？	没有啊!我在上班啊!	1
那你一定擅长钓鱼。你一次能抓多少？	也不多,几十条吧	0
你想去的城市叫什么名字？	我想去的地方太多了，就不一一列举了!	0
你知道我的朋友们说东北地区通常在什么季节不冷吗？	不冷不热的时候啊	0
我是黑带。你想和我竞争吗？	你是黑带？那你赢了!	0
真是巧合。我也在听歌曲。你不听什么风格的歌？	我什么都听,只要好听,哈哈	0
可以哦	欢迎来逛商场!	0
那你有什么厌恶做的事情吗？	哈哈,这个倒是没有	0
你也很可悲，但你父亲是《人民日报》的记者，他为什么会被封锁？	你知道吗,我现在还不知道,我爸到底是怎么被封锁的	0
是的，但是我怎样才能让你看到它们呢？	要不我先加你好友吧,然后给你它们的图片	0
你知道有多少母亲抚养我长大吗？	你是说你是单亲家庭吗?	0
哟	哟什么,这是真的	0
我去过哪个城市？	北京啊，还能去哪儿？	0
我非常喜欢大熊猫，但我还没见过它们。我有空的时候能找到你吗？	可以,我在成都	0
那真巧，你在哪里劳作呢？	我在上海，你在北京做什么工作？	0
一周中的哪一天我要和朋友去卡拉OK？	卡拉是地名,卡拉是一个小镇,在一个很安静的地方	0
我什么时候有儿子？	你不是已经有儿子了吗？	0
你真的100岁了吗？	真的!比珍珠还真	0
你知道我多大了吗？	你不是26吗?	0
你上的那门课叫什么名字？	额，我不知道啊，我上的是英语	1
呗	那你现在是做什么工作啊?	0
你想考哪所大学？	我想上北大	0
你好，你有兴趣和我们一起打篮球吗？	我也不会打，只是喜欢看你们打球	0
你知道我什么时候喜欢游泳吗？	不知道，我只知道我喜欢你	0
你是哪所学校的？	我是北京理工大学的，你呢？有什么打算？	0
你讨厌什么乐器呀？	讨厌钢琴	0
你知道我喜欢多少首歌吗？	不知道!	0
火锅里你最厌恶什么呀？	火锅里最讨厌的是辣椒!	0
当然我喜欢说唱。你听说过吗？	我是个俗人,不喜欢那种风格,我觉得歌词挺伤感的	0
是	我喜欢我的工作!	0
你好，你能帮我照张相吗？	可以啊，怎么拍？	0
你喜欢什么样的电脑游戏？	我不喜欢网游,只喜欢单机	0
真正地你对历史了解很多吗？	不了解也不讨厌，只是不喜欢。	0
嘿嘿，你现在不用劳作吗？	要啊，只是不喜欢而已!	0
我的劳作是一名辩护律师，你是干什么劳作的啊？	我是做律师助理的，你呢？	0
你知道我儿子多大了吗？	不知道，我只知道你比我大	0
咯	那我还是不去爬山了	0
咖啡店在哪里？	就在你的右手边。	0
嗯啊	实现一半,那剩下的一半呢?	0
小黄叫什么名字？	小黄是我的名字，你叫小黄吗？	0
你知道我母亲去世时多大了吗？	不知道!	0
你有多少萨摩斯？	两条,一公一母	0
哟	哟什么啊	0
露丝·赵叫什么名字？	赵露思，赵露思。	0
那你平时劳作忙不忙呀？	这个我就不知道了，反正我是挺忙的	1
咳咳咳	那你喜欢什么样的男孩子啊	0
你什么时候去看电影？	我不知道，我现在还在上班。	0
你知道我什么时候工作吗？	不知道!	0
你好，在呢，你是学习者吗？	我不是的,我只是一个爱好者,你有什么问题么?	0
你是谁？	我是谁不重要,重要的是我在太原,以后会在太原生活	0
你知道我卖什么车吗？	不知道，我只知道你是卖车的	0
一个人需要多少年才能成为一个人？	一个人久了，也就成了一个人。	0
我也觉得他们唱的歌很好。你通常喜欢看什么节目？	我最喜欢看的就是《老友记》了!	0
你很喜欢孩子吗？	一般般吧,看别人家的都喜欢,自己家的就不喜欢	0
你怎么了？	没怎么呀!找不到男朋友就找个女朋友喽	0
刚刚结束。你吃了吗？	吃了，我也刚吃完。	0
你说你想成为一名职业球员和老板。你打算怎么办？	我不知道。	0
我不会。你在哪里练习射击？	我在学校附近的靶场	0
你知道谁的声音让我觉得很开心吗？	不知道啊!你知道吗？	0
你什么时候进来的？	我看到你的帖子就进来了!	0
你知道我喜欢哪种拉面吗？	我不知道你喜欢什么样的拉面!	0
很好。我也有自己的爱好。你跳什么舞？	爵士，jazz，hiphop，poppin	0
你知道我最喜欢的电影是什么吗？	猜不出来,你给我讲讲	0
你的家在哪里？	我的家在广西南宁，你呢？	0
你在学校吗？	没有啊,我在家呢,怎么	0
一个月15000英镑足够养活自己了。那你呢？你有工作吗？	我还在读书，我有工作。	0
你最厌烦干什么呀？	最厌烦睡觉，最讨厌打豆豆，最喜欢睡觉!	1
诶呀	你说你结婚的时候是几岁啊?	0
你还要上多少次厕所？	我也不知道，反正就上了一次	0
这次遇见你也是缘分。我能和你谈谈吗？	我能跟你谈人生吗?	0
你告诉他名字了吗？	嗯,他说这是他给他自己取得名字	0
你知道我在哪里工作吗？	不知道，你在北京哪个地方工作？	1
啦	好吧!我要睡了，晚安!	0
你知道我现在的成绩是多少吗？	不知道，我只知道你很厉害!	0
你的脚踏车很好看啊，新买的吗？	是的，旧的不去新的不来。	0
你什么时候回去？	明天下午就回去了，你呢	0
是的，集中注意力很好。顺便问一下，你是做什么的？	我啊,我也大二,学的会计,你学的什么专业呀?	0
你在哪里？	我在北京，你呢？	0
嘻	我也不知道,不过我觉得你的声音应该不错的	0
太好了。既然你这么喜欢爵士乐，你学过爵士乐吗？	没有，只是从小就喜欢。	0
你知道我背上有多少个纹身吗？	不知道!	0
昨天发生了日食。你没看见吗？	没有啊，我看到的都是阴天!	0
你每天什么时候到家？	八点半,九点半左右吧	1
是的，你还年轻吗？	嗯,年轻,你多大了?	0
你从没去过哪个国家？	我也不知道，只知道我没去过意大利	1
你知道我一周读多少本书吗？	不知道,你说说看	0
你来自的国家叫什么名字？	我是马来西亚的	0
是啊，非常喜欢编程，对了，你是做什么劳作的呢？	我是做网络推广的,销售类的	0
你多大了？	我是89年的，不过我是男的!	0
我在哪家餐厅工作？	我在肯德基工作，你呢？	0
是呢	那你不休息吗?	0
你使用的产品的名称是什么？	名字就是美姿尔	0
我有多少只猫？	你不是说两只猫吗?	0
好吧，你为什么没有失眠？	因为我睡的早	0
你每天工作多少小时？	早上八点上班到晚上10点	0
我最喜欢什么季节？	秋天吧，虽然我不喜欢冬天。	0
除了音乐你还做什么？	我也不知道，只是喜欢而已。	0
你喜欢在一天中的什么时候散步？	晚上，早上，中午，晚上都可以。	0
我来自哪个省？	山东省啊,你不是自己说了吗	0
你没看过故事情节吗？	没有，你有什么好的推荐吗？	0
你养什么？	我养的狗都是公的!	0
我喜欢的狗叫什么名字？	你喜欢的是哪只?	0
这么长时间你在干什么？	我也不知道,反正就是在家里待的时间长了想出去	0
你知道我去哪里出差了吗？	不知道,你自己说的	1
我看了什么电影？	你看的是哪部？	0
事实上，我只是想问你最近有没有什么好的外国电影推荐？	我最近只看了一个关于狗的,叫狗的使命	0
嗯呢	那你唱给我	0
你在哪里学习？	我在天津上学，现在在北京工作。	0
你还厌烦看动画片呀？	不厌烦啊，只是不喜欢看动漫而已	0
你知道我出去的时候多大了吗？	不知道。	0
嘿嘿对	你喜欢看什么书?	0
我不太注意乐队。你喜欢吗？	我知道他们啊,不过我没看过他们的视频,所以我也不知道	0
去年我被选为哪个队？	你是哪队的?我也去,我会加油的	0
你知道我的猫叫什么名字吗？	不知道啊，你的猫是公的还是母的？	0
你要看你的商店多久？	什么小店啊?可以教教我吗?	0
欸	你是怎么长得	0
谁是流行歌手？	王力宏，周杰伦，林志炫，张惠妹	0
我喜欢淋雨，在雨水中感受大自然，你喜欢做什么呢？	我喜欢发呆	0
我看了什么电影？	澳门风云2?	0
你知道我的猫叫什么名字吗？	叫敦敦啊	0
你知道我特别喜欢哪个国家吗？	不就是德国么,我也是啊	0
是的，你应该尽力做你喜欢做的事。你有工作吗？	我在家看孩子呢,我想让你给我也介绍个活,不愿意就算了	0
我喜欢钓鱼和说唱音乐，你厌恶这两种活动吗？	不厌恶，只是不喜欢。	0
哇呜	你呢？在哪儿高就？	0
谁是传奇人物？	甄嬛啊，你不知道吗？	0
好吧，我会的。你不再工作了吗？	嗯,现在没工作了,我现在是自己创业	0
我要去什么样的地方？	你想去哪里？	0
你知道我是哪个城市的人吗？	我不知道啊,我只知道油条是北京人	0
像往常一样，你呢？	我在这儿，怎么了？	0
这也很好。你不喜欢吗？	不喜欢!	0
你在哪？	我在北京，你呢？	0
看你穿着白大褂，你是卫生工作者吗？	是的,护士	0
有多少人？	就我一个啊!你呢？	0
混合性皮肤何时干燥？	我是冬天干，夏天就还好	0
这个城市最受欢迎的商场是什么？	我不知道，我只是喜欢逛超市	0
唉唉唉	想你想的睡不着觉,你怎么还没睡着	0
你喜欢什么样的音乐？	我喜欢民谣，民谣是我的最爱。	0
你知道谁外表丑陋，内心善良吗？	卡西莫多啊	0
你是哪里人？	你是重庆哪点的?	0
你可以去哪个城市？	我想去大理,我喜欢大理	0
！	我是男的，你是女的吗？	0
我多大了？	你不是说十八岁嘛,那就十八岁	0
这个乐队有许多经典歌曲。你没听见吗？	没有听过，我只知道他们的歌。	0
你每年都旅游一次，是你工作的地方安排的，还是你自己休假来的呀？	我自己来的，公司安排的!	1
太好了。你知道什么有趣的地方吗？	你要来找我吗?我带你玩	0
你想要的狗叫什么名字？	我不知道啊，我只是想要一只泰迪	0
我去过除西藏以外的其他省份。每次我出去，我的狗都陪着我。你有宠物吗？	我没有,但是我喜欢小动物	0
嗯啊	你是去的哪里啊?	0
你应该开始工作了？	对啊，我已经在工作了!	0
那你有没有找到劳作呢？	没有啊，我还没毕业呢!	0
你骑车上下班吗？	对啊，骑到单位门口。	0
你什么时候跑一圈？	晚上9点左右吧	0
诶呀	你在上大学吗?还是?	0
呦呦呦	呦,呦,切克闹,煎饼果子来一套	0
是	我在看电影，你呢？	0
你多大了？	90年的,你呢?	0
你平时什么时间放工呢？	平时5点30左右放工	0
顺便问一下，你不喜欢运动吗？	嗯,还好吧,有一段时间经常去健身房,这几天没去了	0
哟呵	哟呵什么?	0
你在家干什么？你每天都在家闲着吗？	我在家没事做啊，我在外面上班啊!	0
你知道谁是我最喜欢的歌手吗？	不知道	0
那很好。你是做什么的？	我是做网络营销的，你是做哪方面的？	0
呜呜呜	你想做什么工作,销售吗?	0
诶	我也不知道为什么啊!	0
你喜欢小植物啊，你都养了些什么呢？	我养了很多小植物!	0
你知道我不喜欢什么样的天气吗？	你不喜欢夏天	0
那你有没有考虑过换一份劳作呀？	我现在就是在考虑啊	0
是的，你今年多大了？	我比你大，我今年25岁了。	0
对吧	嗯嗯，你也喜欢瑜伽吗？	0
是的，但是他们最近很忙，几乎没有时间带我去。你是做什么的？	我是餐饮服务行业的，你也是吗？	0
你好，你用一种可爱的方式打招呼。你是做什么的？	我也是销售	0
你知道谁是反战歌手吗？	不知道,你介绍一下	0
你最喜欢哪个都市旅行呢？	厦门,云南,三亚,青岛,都是我想去的	0
他是哪一年的？	他是91年的,我是95年的	0
你也喜欢听音乐吗？	是的!	0
你要等多久？	我等多久他都不会说,他不会说我就不知道	0
你知道我在哪里学会看日本动画的吗？	这个我怎么知道啊,我也在看动画片	0
没有没有，你在哪劳作呢？	在家里做点小生意,你现在在哪高就呢?	0
你带孩子们出去了多少次？	一个月一次，每次一小时。	0
你知道我有几个兄弟吗？	我知道，他们都是你的好朋友。	0
我还喜欢跟家人开车旅行，你厌恶做什么呀？	我厌恶做家务	0
你知道威海在哪个省吗？	不知道啊!	0
你研究过这个地区吗？	你说的是哪里的?	0
你这么认为吗？	是的呀,我是这样认为的	0
你知道我多大了吗？	不知道，我只知道你比我大	0
天啊，你很难解决这个问题。这肉不香吗？	我觉得很香	0
你靠写故事谋生吗？	谋生谈不上,只是打发无聊时间而已,	0
嗯	你是来找我的吗？	0
你知道他每年带我去看什么吗？	去看你的男朋友	0
。。。	我是医生，你是什么专业的？	0
你知道描述我喜欢的食物的书叫什么名字吗？	不知道,不过我想你可以做给我吃	0
啤酒节在哪里举行？	青岛啤酒节是在海边举行的。	0
你每晚什么时候跑步？	我也没跑过,想找个人一起跑	0
你知道谁乒乓球打得很好吗？	我不知道，我只知道她很厉害!	1
我对钢琴知之甚少。你钢琴弹得好吗？	还行吧，弹得一般般。	0
除了西班牙语，这个城市还讲什么语言？	城市的话，就说普通话。	0
是的，我是一名职员。你忙吗？	我的工作时间就是用手机和电脑做点事情,所以我是很空闲的	0
我多大了？	二十五了吧	0
你结婚了。你在哪里结婚的？	我在上海啊，你呢？	0
你住在哪里？	望京啊,我也住望京	0
我来自河南省洛阳市。怎么了你来过这里吗？	没有,只是在那里上过学	1
你不是经常关注新闻吗？	我关注的是微博	0
你不是很喜欢饺子吗？	我喜欢吃饺子,但不是特别喜欢吃,我更喜欢吃面食	0
你怎么知道水很冷？你下水了吗？	我不会游泳，所以我不下水!	0
啊哈哈	你呢？现在在做什么？	0
你知道谁在看什么吗？	我看的,你信不	0
你知道我喜欢什么时候去公园吗？	我只知道我不喜欢去公园	0
中国的首都是哪个城市？	北京,你这问题问的,真没水平	0
不累，别总说我了，你是做什么劳作的？	我是做电商的，呵呵!	0
我也很高兴呢，你是做什么劳作的呀？	我是做财务的，你在哪个城市呢？	0
嘻嘻嘻	你喜欢看什么类型的文章呢?	0
那我就跟你谈谈。这会阻止你染发吗？	我没染发啊	0
你好，你从哪里来的？	我从云南来的	0
我也很高兴见到你。请问你几岁了？	比你大,我是90的	0
你平时不是很无聊吗？	谁说的,我平时都是很忙的,你不懂不要乱说	0
那你有没有考虑过换一份劳作呀？	换劳作干什么呢	0
你看过中国四大名著吗？	没有，我只看过明朝那些事儿。	0
你知道什么时候很忙吗？	我不知道,但我知道我们今天挺闲的	0
谁在金融业？	我啊,我就是王杰	0
你不喜欢什么类型的电影？	我不喜欢剧情片	0
是你主动要换的，还是公司聘请你的？	我主动换的。	0
是啊，我很喜欢旅游，你做什么劳作的？	我是做旅游服务的，呵呵!	0
你知道我是哪个队的教练吗？	你是哪队的?	0
你多大了？你还能在线聊天吗？	我可以的，你想聊什么？	0
早上好我吃过了。你吃过了吗？	你是在问我早饭吗	0
你一定赚了很多钱，对吧？	那你们家条件一定很好呀?不然怎么会这么有钱?	0
你知道“中国好声音”这首歌在哪里唱吗？	不知道啊!	0
你从哪里来的？	我是杭州人，现在在杭州工作!	0
你去哪儿旅行了？	我在天津，你在北京？	0
对啊呀	我爸对我严格,我妈对我也严格啊	0
嗯啊	那你是在哪上的啊?	0
你非常喜欢软件编程吗？	是啊，很喜欢。	0
你妈妈很能干。你的立场是什么？	我的立场就是我妈妈是个好妈妈!	0
你要复印多少份？	你想要几份？	0
你通常什么时候去？	晚上7点到8点之间	0
你一天中什么时候可以睡觉？	晚上11点左右睡，早上6点左右起	0
独自在家吃饭很容易。你早上不吃什么？	我不吃早饭的，都是在外面吃的。	1
你每天上几节课？	我每天就一节课啊,你呢?	0
珍馐呀我也喜欢，你都喜欢吃什么呀？	我也是,我还喜欢喝牛奶	0
那你放工后都干什么呀？	吃饭，睡觉，打豆豆。	0
什么时候跑步？	我一般都是晚上跑，早上起不来!	0
你知道我在哪里学会看日本动画的吗？	在哪里?我也看看去	0
负责调查的人叫什么名字？	我不知道，我只知道我的名字	0
班上有多少人坐火车？	我们班的话,我知道的是5个左右	0
你知道我特别喜欢哪个魔术师吗？	不知道,是哪个?	0
啊啊	现在后悔也没用了,都过去了	0
你知道因为狗我遇到了哪位妻子吗？	不知道。	0
你有什么好计划吗？	我的计划是，你帮我找个好男人!	0
你说你喜欢美食，山西你有啥自荐的吗？	我喜欢面食!山西的面食都很好吃!	0
你知道我绣这十字绣花了多少个月吗？	不知道，我不知道你绣了多久。	0
你知道我多大了吗？	不知道,但肯定比我大	0
我参加劳作了，一周劳作五天，你是做什么劳作的？	我是做机械设计的,你是做什么工作的呢	0
你喜欢比较宁静的地区，那你平时都会干些什么？	听歌,看书,发呆	0
你是哪里人？	我是广东人，现在在广州工作!	0
独自在家吃饭很容易。你早上不吃什么？	稀饭，稀饭稀饭!	0
我刚扫完地板。你看了什么电视剧？	我在看古剑奇谭呀	0
当你旅行时，你是独自一人还是有人陪伴？	当然是一个人了。	0
嗯，是的，你经常锻炼吗？	我以前锻炼,现在很少了	0
嘁	你喜欢什么样的歌？	0
你在哪个城市？	我在北京郊区，你在哪儿？	0
可以呀，你这个劳作一定不少挣钱吧？	没有啦,我也是在家闲着没事干	0
你们营业多长时间？	我不知道，我只负责卖东西!	0
你知道我喜欢在哪个城市骑车吗？	我不知道啊,所以才问你呀	0
你知道谁是我最喜欢的歌手吗？	我知道啊,郑钧	0
怎么了你不是做了你喜欢做的吗？	做了,但是不怎么喜欢,我不擅长人际,也不善于人际交往	0
我的家乡是新乡。现在我在上海工作。你是做什么的？	我是做平面设计的!	0
你知道因为狗我遇到了哪位妻子吗？	猫的话,我喜欢英短猫和加菲猫	0
你不喜欢什么？	没有什么不喜欢,只要不是很过分的,都可以接受	0
是的，我可以做一些棒棒糖和巧克力。怎么了	我喜欢吃棒棒糖	0
你知道我多大了吗？	不知道，你多大了？	0
你在哪里？	我在北京啊，你在哪儿呢？	0
我在开玩笑。你现在多大了？你还是一个人吗？	是的，我还在上学。	0
是的，我觉得你不高。你有1.6米吗？	没有啊，我是矮子啊!	0
没错没错，那你有自己的劳作吗？	有啊，你要来找我吗？	0
那么，祝福你！你离开多久了？	我离开他快一年了。	0
啊好	你喜欢什么颜色的车？	0
你在哪个城市？	上海	0
你知道我来自哪个国家吗？	不知道,哪个国家	0
不，我是中国人。你从哪里来的？	我是重庆人，从成都来的!	0
不怎么爱说话，你可以教教我怎么和局外人沟通吗？	你和别人怎么认识的?怎么就局外人了	0
我最喜欢哪个城市？	海口啊,我也喜欢海口,不过我喜欢海口的人	0
我还在上高中。你是做什么的？	我啊,我是做护肤品和服装的呢	0
听了多少遍了？	没数过,大概十遍左右	0
道郎的歌叫什么名字？	你去搜,刀郎,道朗,试试	0
你现在出去工作了吗？	我也是今年出来工作的,现在都不知道怎么办	0
你在哪个城市？	我在海淀，你呢	0
你多大了？	比你大，比你大!	0
你知道我16岁是什么时候吗？	难道是我出生的时候	0
你知道我一年跑几次马拉松吗？	我知道啊，我也是一年跑一次	0
你能做到吗？	那你做我女盆友吧,我做的菜你吃了会爱上的哦	0
我对钢琴知之甚少。你钢琴弹得不好吗？	还好啦，弹得还行。	0
哈哈	你也要有了,是吗?	0
你不适合什么行业？	不想说,说了也没用,我也不想在这说	0
你早上什么时候跑步，什么时候？	早上六点半,晚上七点半	0
你知道我来自中国的哪个方向吗？	不知道啊,你说啊	0
你好，我们现在可以聊聊吗？	你是男的,我们没什么好聊的	0
你知道我认为谁的音乐能把我带到这个世界上来吗？	不知道，你说说看!	0
你知道我叫什么名字吗？	不知道,你告诉我啊	0
你知道老师教什么年级吗？	不是小学五年级吗	0
我很喜欢看喜剧，你讨厌看什么类型的电视剧呢？	我不喜欢看电视剧,太墨迹	0
你以前没上网吗？	有啊，不过现在不上网了	0
！	你喜欢玩什么呢?	0
正在看这个节目的年轻人叫谁？	你说的是包青天还是笑傲江湖?	0
我读了多少本书？	你读的书还真多啊!	0
你也喜欢钓鱼吗？	我喜欢的很,就是没时间	0
我什么时候去健身房？	随时都可以，只要你想	0
你是哪里人？	我在佛山呢	0
我喜欢购物，经常出去吃饭。你喜欢购物吗？	还好吧,一般般啦!你是做什么的啊?	0
是的，我正要回家。我可以带你去。你在这里干什么？	我在这里等你!	0
啊好	啊好?	0
你跳的是哪个方向？	我也不知道，我是学舞蹈的。	1
一周中哪一天你没有安排？	我也不知道啊，你有安排吗？	0
每个人都有自己的爱好。碰巧我的爱好是阅读。你喜欢什么？	好文艺呀,我也喜欢阅读,你都看什么书啊	0
你可以说话。你不喜欢谈论什么？	你想问什么,你问吧	0
你什么时候去上班？	初六初七吧	0
是的，你现在主修什么？	我学的是汉语国际教育，现在在做翻译。	0
哦对了	我也不知道啥时候,我都在家闲了一个半月了	0
你知道我是哪个队的吗？	不知道，我只知道你是足球队的	0
孩子们多大了？	大的三岁小的快两岁了	0
看电影呢，你讨厌看电影不？	不喜欢，不喜欢看那些乱七八糟的	0
一个保安能挣多少钱？	这个我就不知道了!	0
啦啦啦	你喜欢什么样的啊?	0
我家有几个孩子？	我是山东泰安的	0
可以哦	你喜欢逛哪个商场？	0
你的家人叫什么名字？	我家没有家人，只有我爸和我妈!	1
广告公司，你的收入如何？	我是做策划的，不是广告行业的。	0
我在浇花。我非常喜欢种花。我在家里种了很多。你最近没干什么？	最近在学车，每天都要练车。	0
你好，新朋友，你在玩游戏。你不用去上班吗？	不用啊，我上班的时候你还没下班呢	0
你知道我需要多少年才能退休吗？	我现在是助理,助理的工作就是做表,做资料,然后做一些文件	0
很棒，你已经劳作了吗？	对啊,我毕业好几年了	0
听着你的口音，你应该是东北人氏吧？	不是，我是河北人，在北京上学!	0
对哦	那就等你想好了,再说咯	0
我也是哎，那你怎么不找男友啊？	你是女的,我是男的,不一样	0
你读《百年孤独》有多久了？	高中时看的，大学时又看了一遍。	0
是呀，你是毕业生还是女生呢？	男生呀,我是今年毕业的	0
你好，我能和你谈谈吗？	可以啊，怎么了？	0
别累了。不要总是谈论我。你是做什么的？	我是做网络营销的，你在哪儿呢？	0
你知道两天后我要去哪里吗？	不知道，我也不知道!	0
你知道和我有关系的人的年龄是多少吗？	我不知道,反正你是30了	0
嗯嗯对	你喜欢看什么类型的书？	0
你一个人长大不容易。你现在怎么样？	还好，我现在在北京，你呢	0
你是哪里人？	广东人，现在在深圳工作!	0
什么季节太冷？	冬天啊!	0
哈哈	你在干嘛呢？	0
你什么时候毕业的？	今年刚毕业，在上海工作，你呢？	0
哟	你也可以找一个啊,只要你有足够的钱	0
你知道我喜欢什么时候做三明治和一杯豆浆吗？	我不知道。	0
~~~	那你现在在哪教学啊?	0
下班后我更喜欢看什么？	你也在上班了?	0
你通常什么时候来上班？	这个我也不太清楚。	0
我也是。你有狗吗？	我也没有,但是喜欢狗	0
会议在一周的哪一天持续了两个小时？	不知道，我也是听别人说的。	0
你知道我什么时候完成高考的吗？	不知道,你是哪的?	0
你知道谁的声音让我觉得很开心吗？	不知道，只知道她的歌都很好听!	1
你不觉得读恐怖小说很可怕吗？	不觉得,觉得恐怖小说是很有意思的事情,我喜欢恐怖小说的气氛和故事	0
那你可以说一下在听什么歌曲吗？	你说你喜欢的类型,我就说几首我最近喜欢的,看是不是你的菜	0
嘛	我妈说猫会抓人	0
你是画家吗？	我只是个画漫画的	0
你喜欢的歌叫什么名字？	我喜欢的很多，最近听的是《像我这样的人》	0
你知道我多大了吗？	十八啊,不是写了么	0
你有什么喜欢的事儿吗？	就是和你在一起	0
你好，聊天吗？	你好,我不知道怎么开头	0
嗯对呀	嗯,就是,不过我现在还没去,下午再去	0
你是哪里人？	我是河北人，现在在北京工作!	0
哦，的确如此。你不想上大学吗？	想啊,但不是现在	0
与你联系的人叫什么名字？	我不知道，我只知道我在海拉尔	0
你是哪个班的学生？	我是学机械的,你也是学生?	0
你有很多朋友吗？	没有，我只有我自己!	0
哦，那你学的是什么啊？	我学的数学教育	0
你是以后想当一名卫生工作者吗？	我不知道，我不想做卫生员	0
你什么时候休息的？	上午9点到下午6点，下午2点到6点	1
你是哪里人？	我是广东人，在广州工作!	0
你知道这位美女博主叫什么名字吗？	不知道啊,我不关注这个的	0
你家里人不多吗？	我家人不多，只有我和我妈。	0
。。	你在干嘛呢？	0
一个月赚多少钱？	一个月也就三千多块钱,你呢?	0
在那里做义工的就只有你一个人选吗？	对的,因为我们这里的义工是自愿的	0
这种坑人的东西你还相信啊？	没被坑过,也没被骗过,就是不信而已	0
我每天什么时候去运动？	晚上啊,我一般都是晚上,因为白天要工作,所以晚上就去运动	0
你是哪里人？	我是广东的呢	0
你是自己想学的舞，还是你家人选替你选的？	我是自己喜欢的，他们也喜欢。	0
你还拍过影片吗？	没有了，都是以前的事了。	1
你以前学过什么专业？	你的意思是你要学别的专业吗?	0
你多大了？	我也是90的，比你大一岁。	1
你在找什么样的工作？	我现在是做销售的，不知道你有没有兴趣？	0
是的，是的，你通常喜欢吃什么？	我一般喜欢吃西餐，你呢？	0
我不怎么看闲书，你有什么好看的闲书推荐吗？	我最近看的是《百年孤独》	0
你刚下班吗？	我已经躺床上准备睡觉了,你还没睡啊?	0
你工作的最后一天是什么时候？	今天是第一天，明天就不知道了。	0
你知道高考后我现在去哪里吗？	你现在在哪?在西安?	0
诶呦	你也是男生么?	0
嗨嗨	嗨，你好!	0
你在哪？	我在北京啊，你在哪呢？	0
你知道我多大了吗？	不知道，我不知道你多大了。	0
我已经读五年级了！我的生活充满了乐趣，你过得难受吗？	还好,你也要加油啊,小学弟	0
你知道我最喜欢的季节是什么吗？	夏天啊,热死人了	0
那你喜欢游泳。你通常在哪里游泳？	我一般在小区里面游，有时候去大润发	0
什么意思？	就是我在找你聊天啊!	0
那你有没有考虑过换一份劳作呀？	我考虑过,但是我的专业性和工作性质决定了我不能换	0
睡觉前我要听多少首歌？	我也不知道,我是看心情听的	0
你知道我是什么时候遇到那个合适的人的吗？	遇到我的时候?	0
我更喜欢哪个乐队？	这个,还真不知道呢	0
额	我也不玩游戏,咱俩能不能处朋友	0
我一直都很健康。你也喜欢健身吗？	是的，很喜欢!	0
你知道我喜欢听谁的歌吗？	不知道啊,谁?	0
你最近看了什么电影？	最近没看电影，只看了书	0
好哇	我加你微信,我们细聊吧	0
你说得对。你是做什么的？	我是做销售的，呵呵!	0
你知道我最喜欢谁的歌吗？	不知道，你说说看	0
你的孩子多大了？	我的孩子还没出生呢!	0
约会是星期几？	星期五，你要来吗？	0
你的尺寸是多少？	你这是要和我比大小吗?	0
我不太注意乐队。你喜欢吗？	没听过,什么乐队?	0
有多少人？	人还挺多,不过都是潜水党,你要来吗	0
你知道我工作的公司叫什么名字吗？	不知道啊，我只知道中粮集团	1
现在还早。你是做什么的？	学生，刚毕业，在读研。	1
你多大了？	我今年刚满十八岁，你应该比我大吧？	0
跟我说说你。你现在在工作吗？	现在在实习呢	0
你多大了？	我也不知道，反正比你大	0
你是哪一年的？	我是98的,应该比你大吧	0
你真的可以说，你多大了？	我也不知道，应该比你大吧!	0
我也知道一些事情。顺便问一下，你没有什么爱好吗？	我的爱好就是吃,睡觉,发呆,看电视	0
你知道我的孙子多大了吗？	不是八岁么?	0
是啊，我就是这么以为的啊，没有学习者你们去院校干嘛？	我们是去学习的啊!	0
你知道哪家餐厅的服务？	不知道,不过听说麦当劳的服务员都特别牛	0
是呢	你有几个知心的朋友呢?	0
好呀	我是女士,你呢?	0
我很乐意。我不看电视剧。这是幸福的负担，你知道吗？	那你乐意看什么	0
你家里有多少只猫？	一只大的，两只小的，还有一只小的。	0
这样啊，你要出差办公还是要来旅游啊？	出差,,	0
你是做什么的？	你是做什么的呀?我是做微商的啊	0
你喜欢听谁的歌？	五月天!	0
你什么时候在操场上跑步？	一般是晚上八九点,你呢?	0
你知道我喜欢什么样的天气吗？	你不是喜欢夏天吗?我也喜欢	0
你多大了？你还能在线聊天吗？	我也不知道，我还没成年。	1
那你想到哪个大学来呢？	那你有什么好的建议吗?	0
你在找什么样的工作？	我在找一份自己喜欢的工作	0
嘛	我妈喜欢狗	0
你不拍什么样的照片？	不拍人	0
你知道谁是反战歌手吗？	我不知道,你知道吗?告诉我吧,我想知道呢	0
你好，你多大了？	我是89年的，比你大一岁!	0
你什么时候开始展望未来的？	我一直都在展望啊，只是不知道未来在哪里	0
嗯对	你是哪个学校的？	0
嗯对	那你是好人还是坏人啊？	0
他的儿子什么时候是大一新生？	这个就不知道了。	0
哎哎哎	我们初中才学	0
这样啊，做机器人是你的劳作吗？	不是,你是做机器人哪一块呢?	0
你刚下班吗？	我还没下班呢,还在办公室坐着	0
哈咯啊	哈咯啊哈咯是什么意思？	0
哈哈好吧，那你厌烦做什么？	睡觉啊，上网啊，看书啊，看电影啊!	0
我是哪里人？	不知道,没兴趣研究	0
是的，那里人很少吗？	还好吧，这里人挺多的!	0
你薪水高吗？	我薪水不高,但我的收入高,哈哈,你的薪水呢	0
可以啊	你也做销售啊?	0
哼	好吧，其实我也是个爱看书的人!	0
目前服役的部队的名字是什么？	陆军侦察兵	0
你好，你从哪里来的？	哦,我是湖北荆州的	0
是呀，我非常喜欢狗，感觉它们很可爱，你讨厌吗？	不讨厌，我很喜欢狗。	0
哇喔	你家有狗吗？	0
你非常喜欢网页设计吗？	我现在已经在自学网页设计了,希望自己可以学好	0
你每天在家看小说吗？	是啊，我喜欢看小说!	0
我很少吃奶酪。顺便问一下，你知道蚱蜢能吃吗？	蚱蜢是一种昆虫，可以吃的!	0
你知道和我一起工作的人几岁吗？	不知道,你做什么的?	0
你知道谁的歌特别好吗？	不知道，我只知道他的歌都很好听!	1
什么时候去墓地最好？	这个要看个人的喜好了，每个人都不一样	0
哇，太酷了。你一个人住吗？	是的,我和我朋友一起去的,我们三个人住在一起,然后自己做饭自己吃	1
你知道我多大了吗？	我以为你比我大	0
娥你好，在干嘛呢？	你好,我在和你聊天	0
我对钢琴知之甚少。你钢琴弹得不好吗？	不是不好，只是不太喜欢。	0
是的，我经常玩游戏。我扮演和平精英。你没玩过吗？	没有，我还小，不知道。	0
你结婚有多少年了？	我结婚三年了	0
和我在一起的人是几岁？	我不知道，我不想说。	0
对对	你好，我是小金，很高兴认识你!	0
你开餐饮店一年大概可以赚多少钱啊？	这个我就不知道了!	0
谁模仿得好？	你觉得呢？	0
我最喜欢谁？	你喜欢谁我不知道，我只知道我喜欢你	0
我更喜欢哪家店？	我也说不上来,反正宜家的我觉得不怎么好看	0
~~~	我是小演员	0
你知道我学习的主题是什么吗？	不知道啊，你是学什么的？	0
难道你就没有那种想看很多遍的影片吗？	有啊，不过都是很老的片子了。	0
你通常在家做什么？	我平时就喜欢在家呆着	0
哈哈好吧，那你厌烦做什么？	睡觉，看书，看电影，吃东西。	0
那你现在是已经参加劳作了是吧？	参加了,但是没干多久就走了	0
我叫王兵。嘿，你吃晚饭了吗？	我吃了，你要不要来点？	0
一周中哪一天你没有安排？	我每天都有安排的，只是你不知道而已	0
你平时讨厌听谁的歌呀？	不讨厌谁的歌，只是不喜欢	0
好吧，你不是老大哥吗？	我是小大哥	0
你的孩子好吗？	他们很好!	0
哦，你不喜欢听什么样的音乐？	不喜欢太吵的音乐	0
你知道歌中有什么动物吗？	不知道,我只知道有郝云	0
你多大了？	那你还小着呢,我都23了	0
你来自中国的哪个地区？	这个有关系吗,中国就那么大点	0
你知道谁是我最喜欢的艺术家吗？	不知道!	0
你真的可以说，你多大了？	我不知道，我只知道我的年龄是秘密	0
啊啊	我想当兽医，可是我不知道我能干什么	0
最小的女儿什么时候出生？	现在就在肚子里呢	0
对呀，我几乎每周都会吃一次，你有什么厌烦的食物吗？	我不喜欢吃巧克力，也不喜欢喝咖啡!	0
你是什么人？	我是一个有故事的人!	0
很好。我也有自己的爱好。你跳什么舞？	爵士和爵士舞都可以，我现在在学爵士舞	0
你知道我为哪个队效力吗？	我只知道你喜欢吃,哈哈	0
你真的不喜欢海迪小吃吗？	海迪小吃是啥	0
呐	你平时都是自己锻炼吗?	0
嗯呢	你是怎么做的呢	0
好的，你是做什么的？	我在建筑工地工作	0
珍馐呀我也喜欢，你都喜欢吃什么呀？	珍稀呀!我也挺喜欢的	0
没关系。你失业多久了？	我失业快一年了	0
真正地你多大了？	那我要叫你姐姐了哦	0
！！！	我的是中华田园犬	0
你看了多少遍？	我看了3遍,你信?不过我是没看完,不知道你信不信	0
你在哪个县？	我在温江,离得有点远	0
是的，你以前做过什么？	做过的挺多的,都是在工厂	0
平常的劳作也很轻松，你呢，你是做什么事情的？	那你工作应该蛮不错的吧	0
你通常喜欢做什么？	玩手机睡觉写作业背书写作业	0
你上的是四川山地大学。你能吃辣的食物吗？	我能吃辣!只是不能吃辣而已!	1
你在哪里学习？	我现在在国内上高三	0
你很讨厌打乒乓球吗？	是啊，很讨厌的!	0
你知道我的朋友们说东北地区通常在什么季节不冷吗？	不知道,我只知道东北的冬天很冷	0
是的，我住在北京西二旗。你通常喜欢做什么？	我喜欢旅游，喜欢摄影，喜欢旅行!	0
对呀，你也厌恶养宠物吗？	没有啊,为什么这样说?	0
你喜欢什么？	喜欢他的歌!	0
哦，你不喜欢哪一位作家的书？	我没有不喜欢的作家,只有喜欢与否	1
哎呦	你是不是有什么事瞒着我？	0
是的，你是做什么的？	哦哦,我还不知道你是学生啊?我还以为你也是做网店的呢	0
你知道我多大了吗？	不知道!	0
你好，请问你是做什么的？	我做韩钰萧面膜的哦	0
这也取决于性能。它不太稳定。你呢？	我也不知道，我觉得我的能力还不够	0
好的，你将来打算做什么？	这个我现在还说不准,因为我是新生	0
狗狗是人类最好的朋友，你讨厌什么狗狗？	我讨厌大型犬，因为我不喜欢大狗!	0
你每次跑多少公里？	最近一次是五公里，之前都是六公里	0
咳	你的店叫什么名字?	0
你多大了？	我今年刚满22岁。	0
我来自武汉。你不去上班吗？	我在找工作,你在哪里上班	0
我早上吃的酸奶和煎蛋，你早上喜欢吃什么食品呢？	我喜欢吃包子，豆浆，包子，包子!	0
今天是星期六。你为什么不早起多睡一会儿呢？	因为我要上班啊!	0
你知道我听的那本书叫什么名字吗？	我不知道,你告诉我呗	0
你在哪家商场？	以前在浦东,现在不在了,你是哪里的	0
你知道我的年级是多少吗？	你不是才上五年级吗?	0
你班的班名是什么？	我是11级的，现在已经毕业了。	0
你是哪里人？	我就是张家口的,在石家庄上学	0
你不喜欢哪个城市？	不喜欢的城市太多了，不知道从何说起	0
不，不，我不怕打扰。你平时很喜欢运动吗？	是滴,我是健身达人哦	0
我最喜欢的乐队是844乐队。你听不见吗？	你喜欢844啊	0
你知道我50岁是什么时候吗？	你今年不就50了吗	0
嘿嘿对	那你是几点的,我想买点吃的	0
喜欢呀，你平时都厌烦玩什么游戏呀？	我不喜欢玩游戏,因为我很菜,我玩不好	0
？？？	是不是克里斯汀史密斯?	0
你多大了？	我比你大呢,我都26了,呵呵,你在上学吗	0
谁是受欢迎的艺术家？	这个我真不知道,没研究过,我只喜欢歌	0
是的，我认为狗很听话。你不喜欢吗？	喜欢呀,我最喜欢狗狗了	0
嗨	你也是开网店的吧?	0
这也很好。你在家做什么？	我也不知道,我是不是废了	0
她有多少只猫？	不知道，我没数过!	0
你知道警察在哪里吗？	不知道!	0
你什么时候去看电影？	明天吧，今天我有约了。	0
你是哪里人？	我是达州的,你呢	0
你好，你吃晚饭了吗？	我吃过了!	0
你有特别讨厌的食物吗？	没有，我喜欢的东西都不喜欢!	1
你是哪里人？	我是威海人，在威海工作。	0
是的，你现在在工作吗？	是啊!我在上班啊!	0
你每天早上锻炼吗？	没时间啊,晚上下班回来还要陪媳妇,所以没时间	0
你通常喜欢什么？	喜欢看书，旅行，看书!	0
你知道糖醋鱼来自哪个国家吗？	不知道啊，我只知道西红柿炒鸡蛋	0
那你一定是个女孩？	对,我就是个女生	0
你通常不喜欢做什么？	不喜欢逛街,其他都还行	0
你知道我什么时候喜欢游泳吗？	不知道，你喜欢什么样的泳姿？	0
是的，我习惯熬夜。你不是还在工作到这么晚吗？	我没工作,在家呢,我都工作好几年了	1
谢谢。你还没有工作吗？	没有呢我是大二学生	0
好吧，你的工资很高吗？	不高,够自己花就行	0
你真的能想象你整天幻想而不工作吗？	那是你,我可不能	0
你不喜欢网上购物吗？	喜欢,但我买得少,我都是在实体店购	0
你没有和友朋逛过街吗？	没有,都是一起在家看电视剧,或者是去超市	0
我18岁了。你今年几岁？	我今年16岁了，明年就18了。	1
啊	你喜欢什么样的旅行呢？	0
谁在看《白夜》？	我看的是白夜行	0
你是哪里人？	我是北京人，现在在北京工作。	0
呵	那我就只能说,你很有爱	0
在	我也是，你在哪个城市？	0
你什么时候回去？	月底吧，还不知道呢	0
你工作的律师事务所在哪里？	在北京朝阳门，朝阳区东直门附近。	0
我现在最大的爱好就是摄影和徒步旅行，你厌烦吗？	不烦啊,我也喜欢徒步	0
你还年轻吗？	我都快奔三了，你觉得呢？	0
你知道我看了什么电影吗？	不知道!	0
运动什么时候进行？	早上7点,晚上9点	0
是的，你夜餐吃的什么？	我也没,你打算吃什么	0
你是做什么的？	我是做技术的，呵呵!	0
你讨厌听谁的歌？	没有讨厌的歌手	0
你什么时候不做饭？	今天啊,明天我也不做了	0
设计在哪里？	在家,在上海有自己的工作室	0
那你在这家店里劳作多长时间了？	也就几个月,但是之前有在其他店做过,不知道算不算	0
。	我想和你聊天，可以吗？	0
我觉得老师是个很好的事呀，你难道不喜欢吗？	你是不知道我是有多苦,我真的不喜欢	0
广东的语言是什么？	粤语，客家话，广东话。	0
你知道这葡萄有几种口味吗？	我不知道啊,你知道吗?网上只卖一个口味	0
你知道我的家人住在哪里吗？	不知道诶,所以才问你嘛	0
哟	你哟啥子	0
你知道我18岁生日是什么时候吗？	不知道,反正不是昨天	0
我喜欢看的新闻广播叫什么名字？	《新闻直播间》和《新闻故事会》	0
似乎是这样。你是做什么的？	我是做外贸的，你在哪个城市？	0
你什么时候有时间做？	这个就不知道了，我也不知道	0
哇，太棒了。我也喜欢。我们找个时间出去吧。你开车，我带我的狗，好吗？	不好,我只跟妹子去	0
你什么时候不做饭？	今天,我妈不在家	0
听音乐和看影片是你平时喜欢的吗？	是的，都喜欢。	0
~~	你这什么意思?我不懂	0
你不想做什么工作？	我不想做销售，我想做行政	0
多少年了？	今年刚满一年，我想知道你是做什么的？	0
嗯啊	你是什么专业的啊,你想找什么工作啊	0
这首歌是谁写的“这首歌叫什么名字？”？	不知道,我就听过他的一首歌,就是不知道歌名	0
我能和你谈谈吗？	可以呀,只要你不是男的	0
你知道我有多少工作吗？	不知道,你是做什么的?	0
我觉得老师是个很好的事呀，你难道不喜欢吗？	可能是我没找到自己喜欢做的事吧	0
在大学肯定要夜宿，那你夜宿的东西都准备好了吗？	我还没呢,什么都没准备呢	0
你有几个孩子？	两个，还有一个弟弟。	0
也不是就是困了，我还是一名学员呢，你已经劳作了？	那你现在在哪里工作呢?	0
那可能是中国的历史文化太悠久了吧，你每天放工都会看书吗？	我放工了就不看	0
你知道我最喜欢的乐队是什么吗？	不知道!	0
你不喜欢甜点吗？	不喜欢	0
你知道特拉巴霍语是什么语言吗？	不知道,那是什么	0
你知道老师教什么年级吗？	不知道啊,你是哪个年级的呀?	0
也没关系。这次我很幸运。顺便问一下，你还在学校吗？	我已经毕业了，现在在广州工作。	0
你知道我什么时候喜欢学摩托车吗？	我不知道，我只知道我喜欢骑摩托车!	0
哈咯啊	哈喽,你还没结婚?	0
你知道谁是最富有的人吗？	当然是我,我最富有	0
你什么时候进来的？	我也是刚进来的，你是哪个学校的？	0
你知道我去哪里出差了吗？	你没说啊,我猜应该是成都吧	0
好吧，你为什么没有失眠？	因为我是学霸,哈哈哈	0
我30岁了。我结婚了。你还是学生吗？	我没说你没权利啊!我只是希望你要好好的,希望你能幸福	0
我一直都不知道你们画师是靠什么挣钱的啊？	卖画赚的钱	0
你明天什么时候吃？	早上吃,中午和晚上不吃了	0
你每天打扫房间吗？	是的，我喜欢打扫。	0
你多大了？	比你小一岁，今年刚毕业。	0
没问题，你喜欢《天堂电影室》这部影片吗？	当然喜欢，很棒的一部片子!	0
你知道学校什么时候开学吗？	学校不是一直都在上学吗?	0
你养了一只乳牛？	是啊，养了只奶牛!	0
你有很多朋友吗？	我有很多好朋友，只是你不知道而已!	0
这样，那你现在一定很有趣吧？	你说有趣就有趣吧	0
呦呵	咋还没睡,你也在找吗?	0
你知道音乐家的名字是什么吗？	我只知道他叫周杰伦	0
你知道我最喜欢的乐队是什么吗？	不知道!	0
你是哪里人？	我是湖北人，在深圳工作!	0
你知道我最喜欢的饮料是什么吗？	不知道!	0
嗯！好的，谢谢你，陌生人。你能问一下你做什么工作吗？	我是做网络营销的，现在在一家互联网公司做运营。	0
你最喜欢的电影有多少？	目前是怦然心动,忠犬八公	0
呦	呦毛线,你又不陪我去	0
你失业了吗？	我没有失业,一直在上班	0
你喜欢听的艺术家是什么？	我也喜欢听陈奕迅,特别喜欢那首,十年,你呢	0
你知道我在哪里上的大学吗？	不知道啊，你是哪个大学的？	0
你不是很喜欢跳舞吗？	喜欢归喜欢,我不会	0
你知道我周末什么时候骑自行车吗？	不知道,你说呗	0
是的，你还年轻吗？	年轻不在年龄,在心态,心态年轻,一切都年轻	0
哇，你的手真聪明。你做了什么？	我做过的手工都是一些简单的,比如,折千纸鹤,折星星之类的,很简单哒	0
嗨喽呀	我都是提前写完作业的	0
你什么时候去公司开会的？	昨天下午呀,怎么了	0
北方人，你喜欢滑雪吗？	不太懂,没滑过	0
你知道我有几条狗吗？	不知道!	0
你知道谁的歌很好吗？	我只知道他的歌都很好听!	0
你什么时候去上班？	明天就去了，我还没去过你家呢!	0
然后努力学习。你的专业是什么？	管理科学与工程，你呢？	0
呵	别呵了，我是摄影师	0
我刚吃完饭，现在躺在床上。你在做什么？	我刚吃完饭,现在躺在床上	0
但是你游泳的时候不需要摘下眼镜吗？	你可以不摘啊	0
你知道他儿子多大了吗？	不知道,我知道她儿子三岁	0
哇喔	嗯,你在郑州上大学吗?	0
职业球员，有这样的职业吗？	不清楚,反正职业球员都是很厉害的	0
你知道我更喜欢哪种动画片吗？	我不知道,你告诉我吧	0
我喜欢谁的歌？	你喜欢的人的歌呗!	0
朱亚文的电视剧叫什么名字？	不知道啊，我也是偶然看到的	0
是	你是哪个学校的？	0
你知道我多大了吗？	32岁,应该有个弟弟或者哥哥吧	0
你好，你现在不工作吗？	在找呢，不知道找什么样的工作	0
你知道我喜欢谁的音乐吗？	难道是许巍	0
当你无所事事时，你有什么爱好吗？	我喜欢一个人呆着。	0
你是哪里人？	我是广东人，在深圳工作!	0
那你呢？你喜欢什么？	我喜欢吃东西算吗	0
王佳多大了？	二十了，怎么？你有什么事吗？	0
你喜欢什么季节？	夏天，因为我喜欢的人在那里!	0
你不喜欢哪个篮球队？	不喜欢中国男篮	0
你在哪里？	我就在北京啊	0
游戏中角色的名字是什么？	那我加你好友,你通过一下呗	0
你叫什么名字？	我姓李,你叫马什么?	0
对了，我不知道你是干什么的？	我是做汽车销售的!	0
你还有其他爱好吗？	这个问题问的我都不知道怎么回答了	0
哦，你多大了？	我是90年的，比你大一点!	0
？？？	就是很喜欢,但是不会玩	0
你知道和我有关系的人的年龄是多少吗？	你有多少关系?	0
那你最讨厌的故事是什么呀？	讨厌啊,不知道	0
你知道因为狗我遇到了哪位妻子吗？	谁？	0
哈哈	你的性别显示的男的	0
你毕业于哪所学校？	哦哦,那你是哪一届的?	0
呦	咋了,我还小	0
对对	你好，我叫张小雨，请多关照!	0
你每天都跑步吗？	对,基本上是	0
你一个人吗？	是的，我一个人	0
你多大了？	我是89年的，比你大一岁。	0
你早餐吃什么？	牛奶,面包,苹果,鸡蛋,燕麦片	0
哇喔	你也在郑州?郑州哪个区?	0
你知道我是哪个队的教练吗？	你不是说你是女足吗	0
谁是流行歌手？	陈奕迅,许嵩也算吧	0
啊，那样的话，你可以告诉我，你通常喜欢做什么？	我喜欢做的事可多了。	0
你还在哪里？	我现在在大连,不过我过两天要回北京呆一周	0
哦？	你是哪里人？	0
那你呢？你喜欢面条吗？	我喜欢米饭，也喜欢面食!	0
你知道我什么时候有女儿吗？	不知道,你告诉我吧	0
是	你朋友是医生?	0
我多大了？	我也才17	0
你知道我多大了吗？	不知道，你多大了？	0
你好你能帮我找到灵感吗？	当然可以，你想写什么？	0
你不休息的时候喜欢做什么？	睡觉，看书，听音乐，看书。	0
你不是为了投资而买股票吗？	是啊,但是我不知道你的意思	0
负责调查的人叫什么名字？	我不知道，我只知道我叫张大宝	0
喏	哈哈!你做给我吃吧	0
你知道我弟弟在哪里工作吗？	在北京哪里工作呀,我在北京待过三年	0
一个月挣多少钱？	也就五千多吧	0
你不是餐厅的服务员吗？	我是餐厅的厨师	0
不，我是研究生。你的专业是什么？	我是学会计的，你在哪个学校？	0
嗯嗯	你呢?你多高?	0
你在做什么？	在做一个小设计	0
我最喜欢玩4459小游戏。你没玩过吗？	我都不知道什么叫4459	0
你知道什么是关于动物的书吗？	不知道!	0
那你有什么厌恶做的事情吗？	没有啊,没有特别厌恶的	0
你在哪里结婚？	北京啊，现在在北京工作了!	0
不，我不再上学了。你呢？	我还在上学啊,你在哪呢	0
我通常在家看电视，研究美味的食物。你喜欢吃什么？	我喜欢喝奶茶!	0
好哦	我是一个执着的人,我的人生只有一个西游,就是西游记	0
谁是中国的流行歌手？	不知道，我只是喜欢听他们的歌	0
你知道我有多少爱好吗？	不知道，你说说看!	0
那你除了劳作的话，平常闲空的时候喜欢什么呀？	我是一个喜欢宅在家的人,没什么爱好,也没什么特别喜欢的事情	0
是的，我通常非常喜欢钓鱼。你喜欢做什么？	我比较喜欢吃啊、逛街啊、上网啊这些	0
你在哪个部门工作？	我在急诊室工作，急诊科是我的大本营。	0
你知道谁是我最喜欢的明星吗？	是王嘉尔呀?	0
你不喜欢吗？	不太喜欢吧	0
我也喜欢音乐。你最喜欢黑豹乐队的哪首歌？	我都喜欢我喜欢他们的所有歌	0
嘿，嘿，我能问一下你平时喜欢吃什么吗？	你要给我买好吃的啊	0
你没有兄弟姐妹吗？	没有，我是独生女	0
我在浇花。我非常喜欢种花。我在家里种了很多。你最近没干什么？	我最近在家呆着，看书，看电影。	0
你在哪里学习？	我在韩国啊,我现在高二,我想去韩国读语学院	0
你同事给你起的绰号？	不是,就是自己取的,你有认识我?	0
...	你喜欢就好，我先走了。	0
你知道我多大了吗？	不知道,我猜你二十了	0
难道你是b站up主吗，那你是有多少粉呀，知道的人士多吗？	我不是,我只是看过视频,觉得挺好看的就推荐一下	0
你也讨厌听歌吗？	是的!	0
你在哪里读研究生？	郑州科技学院,你呢?	0
为什么呀，是因为你的劳作很吵吗？	不是劳作，是工作太枯燥了!	0
你好，你忙吗？你有时间聊天吗？	你好,忙	0
喔	哦,你做什么的	0
好	他们都是我的命	0
你从事销售多久了？	快一年了，最近才开始的。	1
你知道我多大了吗？	不知道。	0
你是在学校还是在工作？	现在在外面实习呢	0
我能问你个问题吗？	当然可以，你问吧!	0
你假期做什么？	我也在家玩手机啊,你是哪个专业的啊?	0
你知道和我在一起的人是几岁吗？	我不知道啊,你说吧	0
你知道我学习的主题是什么吗？	不知道，我也是学历史的	0
你也很喜欢网络购啊？	是啊很喜欢,你也是吗?	0
那很好。你可以放松一下。你多大了，没有孩子？	我孩子都快3岁了	0
你的理由是什么？	我的理由?什么理由?	0
你知道歌中有什么动物吗？	不知道,你唱吧	0
你知道我在哪里学习吗？	不知道,所以问你啊	0
你知道我在哪个军种服役吗？	不知道。	0
你知道美国队长来自哪个国家吗？	不知道,是什么	0
唔	唔,是什么意思	0
这个节目叫什么？	就叫中国好男儿	0
谁毕业于勘萨斯大学？	这个我还真不太清楚啊	0
你这是要来图书馆吗？	我在图书馆门口等你!	0
有多少保险？	你想要多少的呢?	0
和你在同一栋楼演奏的乐队叫什么名字？	不晓得,好像是什么什么乐团吧	0
你只去过哪个城市？	海口，三亚，三亚都去过了	0
我已经读五年级了！我的生活充满了乐趣，你过得难受吗？	我不难受呀,我觉得过的很充实	0
哦，你喜欢独自攀岩吗？	我喜欢独来独往。	0
油画是我艺术史上最喜欢的课程。你通常不喜欢做什么？	不喜欢画画，因为画的不好!	0
没关系。你不想谈什么？	不知道,你可以和我说一些你的故事	0
你知道我喜欢什么时候骑自行车吗？	不知道，我也不知道!	0
那你应该住在离服装店不远的地方？	我现在在我妈这边住的	0
你真幽默。你住在哪里？	我住火星	0
是嘛，真巧啊，那你现在退出工作了吗？	没有啊，我还没毕业呢!	0
嘤嘤	你嘤什么	0
你知道我每天什么时候工作吗？	早上六点多就要起床	0
我在玩电子游戏。你在做什么？	我在玩电子游戏你在做什么?	0
军队中有哪个军种？	2年,解放军陆军	0
好吧，我原谅你。你是做什么的？	我呀,我做的是网店,一个月三四千,嘻嘻	0
对吧	对啊，我很喜欢瑜伽!	0
世界排名是什么？	世界前三，世界第一，世界第二。	0
你知道千寻是谁导演的吗？	不知道!	0
你知道我多大了吗？	不知道。	0
你知道我绣这十字绣花了多少个月吗？	不知道，我只知道你很有耐心。	0
欸	你在哪个城市？	0
好的，你不忙吗？	不忙，只是在等你而已!	0
你来自哪个国家？	我来自地球，我来自火星!	1
你知道什么样的鸡肉很好吃吗？	我觉得鸡胸肉很好吃	0
那很好。你是做什么的？	我是做汽车销售的!	0
我通常只看电视，但我厌倦了看电视。你不是推荐了一部电影吗？	我推荐的都是老片子	0
你知道我最喜欢的乐队是什么吗？	不知道啊,说说看	0
好的，你以后不出去工作吗？	我一直在外面工作啊,在深圳	0
你知道我通常什么时候在湖边散步吗？	不知道，我只知道你喜欢一个人散步。	0
也许吧。你工作累了吗？	还好，还好!	0
夜曲是谁写的？	夜曲是莫扎特写的。	0
这首歌代表了你的心？	那倒不是，只是很喜欢这首歌而已	0
这是编辑的基本要求。嘿，你不工作的时候做什么？	写稿子是一种生活方式!	0
你和你妻子是怎么认识的？	她是我高中同学。	0
你不知道河南栾川和洛阳的崇都沟吗？	知道,我都去过了	0
你知道我是哪里人吗？	不知道啊，你在深圳哪里啊？	0
你来自的城市叫什么名字？	我来自一个遥远的地方!	0
我的劳作是一名辩护律师，你是干什么劳作的啊？	我在律所工作，我做律师。	0
美术老师，你不是在大学里学这个专业的吗？	是啊，不过我现在不干这个了	0
你知道我什么时候喜欢游泳吗？	冬天吧，夏天太热了	0
你知道我什么时候毕业的吗？	应该是上个世纪吧。	0
……	你打算考哪?	0
晚上好你在上课吗？	我在家看电视呢	0
就这么定了。你是做什么的？	哦,那咱俩差不多啊	0
你已经在工作了吗？	嗯,是的,我是做设计的,有兴趣可以了解一下	0
那收藏泰迪熊也是一笔不小的花销啊，你做卫生员的工资够吗？	不知道啊，我没做过。	0
哦，那你学的是什么啊？	教育学,心理学,教育学硕士,教师资格证,都有	0
昨天发生了日食。你没看见吗？	我看到了，可是我不知道是什么日子!	0
你从哪里来的？	我也是河南的,我是焦作沁阳的	0
你每天工作多长时间？	不一定，看情况而定!	0
你知道我是哪里人吗？	不知道啊，我只知道你是郑州的	1
你现在在干什么？	我现在还在上班呢，你呢	0
你业余时间喜欢做什么？	发呆，看书，发呆，发呆。	0
对啊，我超喜欢吃玉米粒，你喜欢吗？	我喜欢糯玉米,脆的也喜欢,但是要煮软一点的	0
平常的劳作也很轻松，你呢，你是做什么事情的？	我做淘宝店的	0
你知道我喜欢什么时候跑步吗？	你喜欢早上	0
不错呀，你非常讨厌看这种电影吗？	是的，我很讨厌!	0
你要吃什么？	我想吃麻辣烫，麻辣香锅，麻辣烫!	0
喏	你很好吗?	0
对了	我也觉得对了	0
你每月能拿到多少钱？	额,四五千吧	0
你什么时候休假？	我明天休息呢,今天晚上上完班就可以休息了	0
唐宋时期有多少个家庭？	这个就不知道了。	0
你买这辆车花了多少钱？	这个不是我的车,不清楚啊	0
你是哪里人？	我是河北的,但不是廊坊的	0
不要伤心了，给，你喜欢吃压缩饼干吗？	我喜欢!但是我不喜欢吃!	1
今天不忙，你没放工吗？	放了,但是不忙	0
我喜欢哪个朝代？	明朝，明朝的很多东西都很有历史意义	0
珍馐呀我也喜欢，你都喜欢吃什么呀？	我也是呢,特别是夏天的时候,特别的喜欢吃甜品	0
那你就有了第一次机会。你忙着工作，你什么都做吗？	不是呀,我是做销售的,你呢?	0
你知道我是哪家航空公司的飞行员吗？	不知道啊,那你告诉我	0
啦啦啦	我不喜欢啦啦啦,我喜欢么么哒	0
你知道最大的猫多大了吗？	不知道,我的是母的,生了一只送不出去了,我在郫县这边	0
到了吗？	到了,在学校呢	0
他们觉得你怎么样？	我觉得他们说的是真的	0
我教哪门课？	你想教哪个就哪个呗	0
你知道我二十岁是什么时候吗？	不知道,反正我20岁	0
你知道我儿子多大了吗？	不知道,不过我猜你应该没我大,我属狗的	0
嗨喽	嗨喽，你在干嘛呢？	0
爵士舞在你的生活中已经有多少年了？	8年了，已经忘得差不多了	0
你的专业是什么？	我是通信工程专业的，你呢	0
我也听说它是纯的。你没有工作吗？	有啊，不过我不想做了。	0
这么多花儿，你是开花店的吗？	我不是,我只是个普通的花友	0
那个问你一个问题，一见钟情，你相信吗？	信,但是没遇到过	0
呃呃	这都是小时候了,现在已经不会画了,而且也没有那份兴趣	0
你知道我最喜欢的啤酒是什么吗？	不知道，你说说看	0
你几岁结婚的？	我不知道，我没结过婚。	0
你知道我50岁是什么时候吗？	我不知道,你告诉我	0
你大概有多高？	我也不知道，没量过	0
你是什么人？	我是你的粉丝，你是我的粉丝吗？	0
？	没有最喜欢,只有更喜欢,我的理解	0
你知道我多大了吗？	反正比我小几岁	0
北京所在地区的名称是什么？	北京市,河北省,天津市	1
~~	不懂,我是男生	0
你在做什么？	我在做财务方面的工作，有什么需要帮忙的吗？	0
我现在很无聊。你方便和我谈谈吗？	不方便，我不想和你谈!	0
你知道我喜欢什么时候喝啤酒吗？	不知道啊,你说说看	0
你坚强的保证是什么？	我会过得比你现在好,比你开心	0
但这很危险。你不怕骑马到河里去吗？	不怕,这是技术问题,技术不到家的话,那就只能说是运气了	0
呃呃	你喜欢看什么电影呀?	0
我家有几个孩子？	我是安徽省合肥市的	0
你的家乡是什么？	我也是山东滴	0
你好，朋友。你在做什么？	你好我在等你	0
我喜欢复古的汽车，你呢，厌恶什么？	我喜欢我喜欢的,厌恶厌恶我的	0
你什么时候大学毕业的？	我今年才刚上大学。	0
你什么时候出去找工作？	今天,你呢,我还不知道去哪儿找	0
负责调查的人叫什么名字？	我叫杨美美，这是我的名片。	0
你知道我什么时候请假的吗？	我只知道你要辞职了	0
你知道她的国籍是什么吗？	不知道啊,怎么?	0
你有多高？	我也才175	0
你每天早上锻炼吗？	我是每天早晚各一次	0
嗨，你好啊，今天劳作忙吗？	你这句话是不是要我回今天的工作很忙啊?	0
你知道我喜欢什么节日吗？	我不知道。	0
好啊，我等着你找到不苦的咖啡茶，对了，你平时没事的时候喜欢做什么啊？	我喜欢发呆，发呆可以让我忘记烦恼。	0
你知道我多大了吗？	你不是说你18吗	0
你是开巡逻车的吗？	对的,巡逻车	0
你们有自己的展览吗？	没有，只有自己画的画。	0
是的，我最喜欢看一些恐怖电影，电视剧了，你讨厌看吗？	我不喜欢!但是我喜欢看!	1
士兵在哪里？	在北京啊，你问这个干嘛？	0
你是哪里人？	我是河北沧州的	0
你知道我最喜欢谁吗？	不知道!	0
你呢，你也是在放工吗？	我是在上班啊	0
你一定要担心天气吗？	对啊,天气不好的话,就没办法练了	0
恭喜你啊，什么车辆呀？	谢谢，奔驰a级。	0
好哇	可以的啊,你加我微信吧	0
那你受欢迎有什么你觉得很紧要的原因嘛？	我喜欢他，他不喜欢我。	0
哦？	你喜欢看书吗？	0
你能从网上商店得到多少钱？	不多啊,一天也就一百来块啊	0
你厌烦看电视剧还是综艺节目？	都不厌烦	0
可	你在家干啥?	0
谁是贝斯手？	我是吉他手，贝斯手是我的朋友	0
是的，你是做什么的？	我是做平面设计的!	0
那你为什么不去呢？你现在忙吗？	嗯嗯,是呀,最近都有点小忙,所以就没去	0
你要回家吗？	不回家,你是?	0
你喜欢听什么样的歌？	我也是,英文歌	0
哇哦	怎么?你有兴趣?	0
我在操场上跑了几圈？	十圈。	0
你知道和我住在一起的人的年龄是多少吗？	你多大啊？	0
你的尺寸是多少？	我身高170,你看我能骑什么车?	0
什么时候在城里散步好？	现在就很好啊，我每天都散步的!	0
销售代表的月薪是多少？	这个我就不知道了，我不是销售	0
哟呵	哟呵什么?	0
中国的花园猫是谁？	我也不知道啊!	0
你好吗我在银行工作。你工作过吗？	工作过,你在哪个银行	0
这很普通。你有自己的房子吗？	有啊，不过不是我的，是我朋友的。	1
有多少年了？	4年多了，快4岁了	0
王力宏最喜欢的歌手是谁？	你喜欢的歌有哪些	0
你有小狗吗？	有啊，不过我不喜欢，我喜欢狗	1
你好，你现在做什么？	我现在做的是金融,投资这一块	0
我喜欢做饼干，更喜欢吃饼干，你平时厌恶吃什么呀？	我不挑食的，只要是甜的都可以!	0
你早上什么时候才能起床？	6点半,晚上11点睡觉,7点半起床	1
是的，你不是经常来郑州玩吗？	没有啊，我在上海工作。	0
你知道我读的那本书叫什么名字吗？	我没读过,所以不知道	0
我的猜测仍然相当准确。你们学校允许染头发吗？	不让,不过不被发现就好	0
我最喜欢的乐队是什么？	没听过,有没有介绍?	0
哦哦，那你一天劳作多长时间呢？	我一开始工作的时候是每天8小时,现在的时间是每天4小时	0
哦~你们年轻人通常喜欢做什么？	年轻人喜欢睡觉打游戏看电影	0
这样啊，那你平时讨厌做什么呢？	讨厌的多了去啦	0
这样啊，那你是做什么劳作的呀？	我也是个程序猿,不过我不是码农	0
你来自的国家叫什么名字？	我也在浙江,你在哪?	0
你不是经常自己做饭吗？	对啊,所以才自己做啊,	0
人们说你很浪漫。这就是你辍学的原因吗？	不是，只是我不想让自己失望而已。	0
你想去哪个城市？	哪个都可以,只要是北京	0
你减掉了多少公斤？	十公斤吧，我也不知道	0
哟	你知道我是谁吗？	0
你知道你见过这些生物吗吗？	不知道，我只知道我没见过	0
哼	我是男生我就不会说这句话	0
是的，你写小说赚很多钱吗？	我不想挣钱,只想写小说,写的很辛苦,我想有一个属于自己的小窝	0
你知道谁的歌真的很好吗？	我喜欢张惠妹的	0
你好啊，你讨厌玩王者荣耀吗？	没有讨厌不讨厌,就是没兴趣	0
你现在上大学了吗？	是啊，马上就要毕业了!	0
你对这个星期天感兴趣吗？	星期天有什么活动	0
我也很怀念院所的过活，你在院所过的怎么样？	还行吧!你呢？在哪个院？	0
哇啊	你喜欢这个吗？	0
嘘	好吧,我会当真的	0
你知道我是哪家航空公司的飞行员吗？	你不说我怎么知道?	0
哦对了	我的意思是,等我忙的差不多了,你的时间就有空闲了	0
噗	你也喜欢吗？	0
你知道谁是公主吗？	不是艾莎吗?	0
你最喜欢谁？	甄嬛啊!	0
郑大岳是谁？	郑大岳就是我啊，你不知道吗？	0
是的，那你平时除了工作都讨厌做什么呢？	我觉得我不讨厌什么	0
你通常什么时候去？	我一般都是晚上去，有时候下午去。	0
还没有呢，我晚餐吃的晚，你吃过了吗？	我吃过了!	0
你打算学什么样的乐器？	我想学小提琴，或者尤克里里之类的。	0
嘿，嘿，你现在不需要工作吗？	不需要，我在做我的工作!	1
对啊，但是我好像劳作的不是很开心，你是做什么的呀？	我做室内设计的。你呢？在哪个城市？	0
啊哦	你呢？还好吧？	0
电影里是谁？	不知道，没看过	0
我收到了，那您尊姓呀？	我姓王，你是哪儿的人？	0
你多大了？	我已经过了法定结婚年龄了。	0
我母亲去世时多大了？	不知道，我也不知道。	0
你好，我遇到了一件事儿，我好难过呀，你能听我说说吗？	什么事儿？	0
你什么时候开始上学？	九月初吧，我也不知道。	0
你知道我多大了吗？	你不是说你七岁吗	0
我通常读什么书？	我不知道哦,你自己的喜好	0
听你这么说你还没有劳作吗？	没有，我在上班，你在干嘛呢？	1
什么时候跑步？	晚上六点半到八点半!	0
哟呵	我现在大二,准备明年去	0
你在哪里？	我在广州,你是在深圳工作吗?	0
啧啧啧	真的,我还喜欢坦克模型,还有航空母舰模型	0
是在课外班玩耍的吗？	是的，是的!	0
是的，我能为你做些什么？	我不知道，我想知道。	0
你多大了？	我今年刚满十八岁，你猜我多大？	1
谁是中国的流行歌手？	不知道，我只知道周杰伦	0
我没有午睡的习惯，你是一个厌恶午睡的人？	我是个嗜睡的人	0
你知道我什么时候开始学习的吗？	我不知道，我只知道你在干嘛!	0
那你厌烦在空闲的时候做什么呢？	看书，看电影，听音乐，看书。	0
那干你们行销的是不是都会有人经常辞职啊？	这个我不能回答你,我也不知道	0
我刚结婚，准备去度蜜月。我现在在深圳。你知道深圳附近该去哪里吗？	你想去哪里啊？	0
你的家庭生活困难吗？	不困难，我家人都很好!	0
你知道我喜欢听什么管弦乐队吗？	不知道,你说说看吧	0
你一个月挣多少钱？	我一个月挣三千块钱,你呢?	0
你喜欢音乐吗？	我喜欢，我也喜欢。	0
你知道docosa的西班牙语单词是什么吗？	不知道。	0
对	你喜欢什么茶？	0
你妈妈是做什么劳作的？	我妈在家带孙子,没有劳动	0
他们在一起度过了多少年？	一年半吧，我也不知道	0
你在哪里工作？	我在上海上班，你呢？	0
这件事发生了多少年？	两年了吧,时间也不长	0
看来你们很相爱。你有孩子吗？	没有呢,我还在上学	0
你一天能挣多少钱？	那还可以啊,那能不能教教我呢?	0
不，我只是对我的家庭不满意。你是做什么的？	我是学生，我在学校帮忙。	0
你的孩子多大了？	我孩子也是三岁	0
！！！	我是说我不知道我的狗狗叫什么名字	0
我也很高兴见到你。你今天有工作吗？	有啊，我今天在这里上班!	0
是的，你会打篮球吗？	会呀,我可以教你	0
你知道我开始练习的时候多大了吗？	我不知道。	0
你知道我在哪里毕业的吗？	你在哪毕业跟我有关系么	0
啊，你什么时候下班？	六点,不过我要六点半才能过去	0
你知道我来自的城市叫什么名字吗？	不知道，你告诉我吧!	0
你在哪里上学？	我在海淀这边	0
你儿子多大了？	4岁呀,我儿子3岁了,你家孩子比我家儿子大吧?	1
你每天都在公园跑步吗？	对啊，我住的地方离公园很近	0
哟呵	你也是?同行?	0
在大学肯定要夜宿，那你夜宿的东西都准备好了吗？	还没呢,不知道要带什么	0
你知道我家有几个男孩吗？	不知道,不过我想你不会是坏孩子	0
你知道出差需要多长时间吗？	不知道，我也不知道!	0
负责孩子责任的人叫什么名字？	叫小二，小二负责挣钱养家!	0
这个城市最受欢迎的商场是什么？	我不知道，我只知道大润发	0
是的，我喜欢晚上出去散步。你喜欢做什么？	我晚上出去也喜欢散步,但是我不喜欢跑步!我喜欢散步	0
…	不严重的话,就好	0
谁是个好歌手？	我觉得张玮玮的歌很好听。	0
...	你知道这里是什么地方吗？	0
这样啊，那你平时讨厌做什么呢？	讨厌做家务,讨厌做饭,讨厌洗衣服,讨厌上班	0
哦哦嗯	怎么不好了啊,说给我听听	0
你知道我来自哪个城市吗？	不造,我是学渣	0
你知道我喜欢看谁的电影版《爱丽丝梦游仙境》吗？	不知道啊?是谁的啊?	0
你听什么书？	我听的书都是比较杂的，你喜欢什么类型的？	0
嗨，你好，你能给我推荐一些古典音乐吗？	你喜欢听什么风格的？	0
你没有孩子，不是吗？	我有个女儿，她很可爱!	0
你假期喜欢做什么？	我喜欢睡觉，睡觉是最好的休息!	0
喔	你呢,是做什么的,也喜欢历史吗	0
你很厌恶部队吗？	是的，非常厌恶!	0
你知道我最喜欢谁的歌吗？	周深，周深!	0
你知道什么时候会有马拉松友谊赛吗？	这个我不知道啊,我们这里好像没有马拉松,我不是你们那边的人	0
你开始学钢琴的第一个年级是什么时候？	小学二年级。	0
那你身材是不是很坏呀？	没有啊，只是不喜欢紧身衣服而已	0
我没有最喜欢的乐队。你能推荐一些好歌吗？	那就多了,你自己去听吧	0
哦对了	对了什么呢?	0
太重了。你很棒。你不是赢得了比赛的第一名吗？	我是第一名，可是我不想去!	0
你什么时候去上班的？	我已经上班一个半月了好吗	0
诶呀	我真的叫李海	0
你好，你不能说话吗？	可以啊，只要你不嫌我烦就好。	0
喝啊	我妈也不让我在家里养	0
你要看你的商店多久？	不用呀,我就在那挂着,有人买就买,没人买我就不看了,一月也有几千块	0
你以前有工作经验吗？	有啊，不过我是做销售的	0
你不是餐厅的服务员吗？	我什么时候说我是服务员了	0
你在你家附近开的企业吗？	不是，是我朋友开的。	0
食堂里有多少素菜？	我也不知道,我一般吃素	0
你知道我多大了吗？	你不是说你上初中吗?应该在十六七,十七岁左右吧	0
那你每天不工作岂不是很有趣呀？	是的，很有趣。	0
你没有强迫症吗？	有啊!但是我不知道怎么治!	0
是的，我今年是大一新生。你不一样吗？	我也是大一的，你哪个学院的？	0
你知道特拉巴霍语是什么语言吗？	我只知道特拉法尔加冕语	0
你儿子多大了？	那咱俩应该差不多大,我儿子也是	0
你在上大学吗？	对啊，怎么了？	0
你知道高考后我现在去哪里吗？	不知道,你告诉我呗	0
那你一般讨厌做些什么呢？	这个太多了,什么都讨厌	0
可以啊	你们是哪里人啊?	0
在	好吧，我也是做平面设计的。	0
你通常不喜欢做什么？	额,我不知道,好像没有,我比较宅,所以没感觉	0
你知道我喜欢谁吗？	不知道,我只知道贝克汉姆是一个很帅气的大叔	0
啦啦啦	哈哈,不过喜欢你的声音	0
你经常写什么样的小说？	我也写过短篇,不过没写多久就放弃了	0
你在哪里上学？	郑州啊，你呢？	0
你知道我多大了吗？	不知道,我只知道,你很调皮	0
看你的气质不错，一看就不是一般人，咱能接个朋友吗？	可以啊，你想要什么样的朋友？	0
你知道它已经流行了多少年了吗？	我知道,所以我一直都在看	0
我最喜欢的影片是《阿甘正传》这种类型的，你业余时间喜欢做一些什么事宜啊？	我喜欢听音乐，看书，看电影。	0
好的，你没有什么爱好吗？	我喜欢听音乐，看书，旅游!	0
学生在哪里？	在北京，你呢？	0
我的猜测仍然相当准确。你们学校允许染头发吗？	我们学校不可以染头发	0
他妻子多大了？	他妻子比他小几岁	0
我才13岁。离我毕业还有很长一段时间。听你说，你已经毕业很久了，不是吗？	是的，是的。	0
那么，你难过是因为你想坠入爱河吗？	我只想和你坠入爱河,你愿意吗	0
你对摩托车没有感觉吗？	没有，我只喜欢骑摩托的人!	0
你知道我听的那本书叫什么名字吗？	不知道!	0
你多大了？	我已经是个成年人了!	0
是的，我面前是深棕色的。也有人这么说。你到底是不是在旅行？	我是在旅行啊,不过不是来这里旅游的	0
那你这些天都不能上班了，不是吗？	是的，是的，可是我已经辞了。	0
是的，南方人对此很担心。你结婚了吗？	没有，还在读书。	0
你星期几去姐姐家？	星期六啊，你有时间吗？	0
？？？	你是不是有什么事瞒着我？	0
啊啊	你在哪个医院上班?	0
我们别谈纹身了。让我们谈谈你。你工作不忙吗？	忙啊，忙得都快死了!	0
你在哪里工作？	我在北京啊!	0
哎	别叹气，都会好起来的!	0
你什么时候有时间做？	现在就有时间啊，你想做什么？	0
你有压力吗？	没有,但是我感觉我要崩溃了,我要疯了	1
你知道谁是我最喜欢的艺术家吗？	我不知道,你可以告诉我吗	0
你有没有养小植物？	有啊，养了很多呢!	0
我是哪里人？	不知道啊,你在哪里上学?	0
你通常不喜欢做什么？	不喜欢就是不喜欢!	0
你什么时候毕业的？	那就是你比我小一届	0
你失业多久了？	没有失业,就是感觉自己没什么发展,所以想换个工作,有什么建议吗?	0
你好，你好，你不能交个朋友吗？	不能,我不喜欢你这样的	0
对	那你就不要开了	0
对呀	我也是你的忠实粉丝哦!	0
你是小姐姐还是大哥哥？	我是小妹妹,大哥哥	0
怎么了你要做宫保鸡丁吗？	我要吃!不做	0
哪个国家有才艺表演？	韩国的那个	0
你知道我多大了吗？	不知道。	0
那很好。你自己吃饼干吗？	我喜欢吃饼干!	0
我来自上海。你呢？	我也是!	0
你知道我在哪里工作吗？	不知道，我只知道你是重庆的	0
你知道我有几个儿子吗？	不知道，我不知道。	0
你将来不找份厨师的工作吗？	我现在就在找啊!	0
好哦	你看过西游记后传没	0
你知道现在是哪一年吗？	不知道，你说说看!	0
对不起，我没有猫。你有猫吗？	我有猫，不过不是你那种类型的!	0
咯	你喜欢什么口味,我给你买	0
那你平时觉得玩耍吃力吗？	也不吃力	0
你是哪个班的学生？	我是中职部的	0
那你最讨厌的是他们的哪一首歌呀？	我不讨厌他们的歌，只是不喜欢!	0
你家有多少只猫？	两只，一公一母，都是公的!	1
你知道下班后我会和朋友一起打篮球吗吗？	不知道,我是问你多大呢	0
哦，哦，你不是一个独立的摄影师，也不是在工作室工作吗？	我是做摄影工作室的	0
你不厌倦每天养宠物吗？	不会啊，我喜欢猫猫狗狗	0
嘤嘤嘤	哈哈,怎么啦,你也是练体育的?	0
好的，你现在在工作吗？	没有,在家带孩子	0
你知道我最喜欢的乐队是什么吗？	我知道,我说披头士已经死了	0
你知道“docosa”的西班牙语单词是什么吗？	不知道,我只知道我在学,但是我不知道你在说神马	0
我比较喜欢汽车，你厌恶什么？	我厌恶,我不喜欢的都不讨厌	1
你知道我什么时候开始踢足球吗？	不知道。	0
你上的是哪所大学？	广工啊，怎么了？	0
谁写了一本关于情感写作的书？	我不知道,我不懂	0
你知道我多大了吗？	不知道，我只知道你比我大	0
你知道我要吃多久土豆吗？	不知道!	0
你从哪一年开始？	不记得了，应该是初中吧。	0
你什么时候去训练的？	今天早上啊，你没看到我吗？	0
唉	你家的猫咪是公的还是母的？	0
你做什么运动？	羽毛球、网球、篮球、乒乓球、羽毛球。	0
听你这么说你还没有劳作吗？	没有，我一直在工作啊，只是很少看到你	1
哦，你的工作可能很乏累吧？	是的，很累，非常累!	0
你知道我喜欢在哪个国家听摇滚乐吗？	在德国?	0
你一天吃多少个馒头？	就三个呀	0
你知道我有几个孩子吗？	不知道,你说说吧	0
那你在这家店里劳作多长时间了？	没几天,我是新招的,还没正式上岗呢	0
对吗	嗯，是的，你在做什么工作？	0
很多人经常去你的录音室录歌吗？	嗯,有很多,但都是我的朋友	0
你知道我养的狗多大了吗？	不知道，我只知道你养的狗很可爱	0
我不知道目前该找什么工作。你是做什么的？	我是做室内设计的!	0
那个叫小英的人叫什么名字？	她叫小英，是我的好朋友。	0
你知道它最喜欢住在哪个季节吗？	不知道,我也不养宠物	0
真幸福，你是做什么劳作的？	呵呵,就是在掏宝上做了个小店,卖卖衣服	0
不累，别总说我了，你是做什么劳作的？	我是做软件开发的，你也是吗？	0
你不想和解吗？	我想啊,可是他不愿意	0
你一周几点在家？	我一般都是11点左右到家的	0
离上次有多少个月了？	上次是七个月，这次是八个月	0
我能和你谈谈吗？	可以啊	0
你喜欢糖吗？	喜欢啊,很喜欢吃糖	0
那你现在是已经参加劳作了是吧？	我现在还是学生,只是提前准备	0
补贴的最低年龄是多少岁？	真的,你可以上网查一下	0
你什么时候满20岁的？	今年才满的，你是哪一年的？	0
你知道我多大了吗？	我不知道你多大,但我知道我30了	0
今天初次见面，能请你吃个米饭吗？	我只喜欢吃面	0
电影里的电影叫什么名字？	我也不知道,没看过	0
我最喜欢的乐队是什么？	我也不知道!	0
你的分数是多少？	不知道,还没有查,应该不高	0
你知道我多大了吗？	不知道，你几岁了？	0
我是面包车行销，你喜欢车子吗？	我喜欢面包车，你也喜欢吗？	0
有多少年了？	两年了呀,去年开始养的,养的时候还是个小龟苗呢	0
你知道黑豹的吉祥物是什么动物吗？	不知道!	0
我教哪门课？	教数学吧,我数学很差	0
你有几条狗？	我现在一条都没有了	0
是的，有电视版。你看到了吗？	有看到,但是不知道好看不好看	0
你现在没有工作吗？	那你工作怎么样?	0
你什么时候毕业的？	我毕业好多年了,你是哪里人?	0
我有几个女儿？	两个,羡慕	0
那你讨厌哪些类型的音乐呢？	我不讨厌任何乐器和声音,因为都是我的爱,我喜欢它们,我讨厌什么呢?	0
你好，请问你尊姓？	王,你有什么问题吗?	0
你现在做什么？	我现在在上海做设计,你呢?	0
是的，我非常喜欢跑步。你在做什么？	我在看《霍乱时期的爱情》	0
你读过多少本书？	我也记不清多少本了,你呢?	0
有多少年了？	小学开始看,现在大学快毕业	0
你知道我多大了吗？	不知道!但是我喜欢吃!	0
你什么时候去上班？	我已经上班了呀,我在实习呢,在上海	0
和你聊天要花多少钱？	我可以给你打折,只要998	0
住在底特律的人的年龄范围是多少？	二十七岁，他们都是我的好朋友。	0
你什么时候去上班？	明天去，后天上班，你呢？	0
你不是每天都锻炼吗？	我有空就锻炼一下,你是怎么锻炼的?	0
这孩子多大了？	一岁四个月了啊	0
你是哪里人？	我是湖北武汉,目前在深圳上班	0
嗨喽呀	你是不是想问我是什么性质的工作呢	0
他走了多少步？	没数过，反正走了五步。	1
你知道我喜欢什么社会吗？	不知道，我只知道你喜欢我	0
你说的是由李仁港导演执导的哪一部影片吗？	是的。	0
你在工作？	对啊，我在上班啊!	0
上海是个大城市。你是上海人吗？	不是，只是在这里工作而已。	0
嗯啊	你现在上大几了呀?	0
你通常喜欢出去吗？	我不喜欢，我喜欢宅在家里。	0
你的高考是什么时候？	就是这个月啊	0
对呀，我是个女孩，我还喜欢斑马，你厌恶吗？	不厌恶，只是不喜欢!	0
那饭团是什么菜？	就是饭团啊!	0
是吗，那你最厌恶画什么了？	我最厌恶画画了	0
好的，你通常不喜欢美味的食物吗？	不喜欢，我喜欢吃辣的	0
喏	这是你做的吗?看起来好好吃	0
你通常有什么特别的爱好吗？	我喜欢听音乐、看电影、看书、看书...	0
这个周末你要上班吗？	我周末都要上班的	0
你喜欢什么季节？	冬天!夏天太热了!	0
好呀	你是做什么工作的？	0
你要结婚了吗？	没有呢,还没对象呢	0
93年你多大了？	我今年刚过完生日，应该是22岁。	0
你知道我最喜欢谁的歌吗？	不知道，你说说看!	0
在俱乐部里，我已经完成了我正在做的事情。你在做什么？	我在做一个小调查，你有没有兴趣？	0
不怎么忙，你是在跟爹妈一起住还是自己住的？	和爹妈一起住的,不忙就好	0
请问你是做什么的？	我是做室内设计的。	0
我也很高兴见到你。你现在在做什么？	上班,不过现在有点闲	0
你在哪里工作了三年？	我在深圳，你呢？	0
好呀	怎么加你呀,微信可以吗	0
。。。	你是男的还是女的？	0
那你一定很年轻吧，体育爱好者？	嗯,是很年轻,不过体育爱好者谈不上了	0
你喜欢读书吗？	喜欢，非常喜欢!	0
你什么时候出去？	我一般都是下午四点多去的	0
你知道我男朋友什么时候去看我最喜欢的艺术展的吗？	我也不知道,你告诉我	0
你是哪里人？	我也是来玩的,哈哈	0
一个月挣多少钱？	4左右啊!还可以吧	0
你知道每天什么时候上瑜伽课吗？	不知道，我都是在健身房	0
你男朋友多大了？	我没男朋友，我是单身狗!	0
请问你现在做什么？	我现在在家里做点小生意	0
我正在吃早餐。你吃了吗？	我吃的是面条	0
主要是因为他们现在很敏感。你没有足够的工作假期。你出国吗？	我的假期足够我出国,只是没时间没钱	1
。	你是男的还是女的？	0
我家有几条狗？	好像有四条狗!	0
你知道我最喜欢的电脑游戏是什么吗？	不知道。	0
这样啊，那你平时讨厌做什么呢？	讨厌什么?没什么讨厌的啊	0
我买了什么车？	不知道你买的啥车	0
你对这个星期天感兴趣吗？	对你,比较感兴趣	0
你是哪里人？	我是河北人，现在在北京。	0
你55岁是什么时候？	我已经50岁了，谢谢你的关心!	0
你好，在呢，你是学习者吗？	对,我是学生	0
你唯一喜欢的饮料是什么？	白开水,矿泉水,茶或者咖啡,其他的都不喜欢	0
是的，你是哪里人？	我是湖南人哦,那我们离得不算远呢	0
嗯啊	你呢梦想是什么	0
嘛	羽毛球也是我的强项，你呢？	0
你不喜欢去咖啡馆吗？	喜欢,我一般去的都是小咖啡馆,不算是大咖啡馆	0
你知道他唱了什么歌吗？	不知道啊，只知道他的歌都很好听!	0
有的呢，我很喜欢听五月天的歌，是他的忠实粉丝呢，你有讨厌的么？	我不讨厌他们，只是不喜欢他们的歌!	0
你好，我现在是实习生。你失业了吗？	我还没找到工作呢!	0
厉害啊，你可能从事这一方面工作很多年了吧？	嗯,这方面工作,是从我刚上大学开始做的	0
你班的班名是什么？	我在家带孩子呢,没上班,你在哪上学啊,你怎么知道我是学生呢?	0
你知道我吃什么食物吗？	不知道!	0
一个人每周需要多少天去上班？	每天都得去	0
程序员，你没有和同事们玩游戏来放松吗？	没有，我是个内向的人，不喜欢社交	0
小桂的真名是什么？	小瑰是我自己的圈名,桂是我喜欢的人的姓	0
我去过除西藏以外的其他省份。每次我出去，我的狗都陪着我。你有宠物吗？	没有,没时间,我自己都照顾不好自己	0
这对你来说并不容易。你父母是做什么的？	都是种地的	0
不，你一个人住吗？	是的。	0
你工作不忙吗？	我在家里做网店,工作比较闲	0
你什么时候大学毕业的？	我是今年刚毕业的。	0
如果你的薪水不够怎么办？	我的薪水够啊!	0
一个人一个月挣多少钱？	我的话大概三千多,加上我的工资一年有个六七万吧	0
呦呵	你是做哪方面的呢？	0
安息日你几点上班？	我八点上班,我是七点多就要到公司的	0
我现在在一家建筑公司工作。你呢？	我是问你什么建筑公司	0
我在辩护律师事务所做前台，你呢？	我也在律所，你是律师吗？	0
我在听歌呢，最近很喜欢听摇滚乐，你讨厌听音乐吗？	不讨厌，只是不喜欢!	0
你叫什么名字？	我叫李红，你也叫王红吗？	0
什么时候发生？	月底啊，还有一个月呢!	0
你知道我最喜欢的乐队是什么吗？	我只知道有一个乐队,叫阿信	0
你爱上了这位同事。他能感觉到你非常爱他吗？	他说他也很爱我	0
喝啊	喝了两个月了	0
那很好。你通常不喜欢吃什么？	我不挑食的，什么都吃!	0
对呢	我是护士,你在哪个医院啊	0
喝啊	你是哪个学校的？	0
那你平时不忙的时候讨厌做什么？	看书，听歌，看书，发呆。	0
是嘛，那你劳作是啥啊？	我是打工的，只是在这里工作而已!	0
你什么时候送走的？	就今天下午啊，它还在我床上睡觉呢	0
哦，那你学的是什么啊？	数学专业的啊	0
呗	你也在超市做?	0
我只能看一眼。跟我说说你。你打算怎么办？	打算开个淘宝店卖卖衣服,不知道好干不好干	0
你多大了？	我也86年,不过还没结婚	0
你爱上了这位同事。他能感觉到你非常爱他吗？	我觉得他应该可以感觉到	0
好的，我喜欢川菜。最近，该公司在楼下新开了一家。你可以试试。你喜欢辛辣的食物吗？	我不喜欢!我喜欢清淡的!	0
好	你在哪里找?有目标了没?	0
没有，我在家照顾孩子，没法出去上班，你放工了呀？	嗯嗯,放了两个多月了	0
嗯嗯，你呢是做什么劳作的？	现在在家,没什么事情做	0
你讨厌相亲吗？	不讨厌，只是不喜欢。	0
你开什么类型的车？	我开的都是普通的车	0
你非常喜欢网页设计吗？	那就来参加我们的培训吧	0
你知道我什么时候喜欢骑自行车吗？	不知道,为什么?	0
你是哪里的学生？	我是河北的，现在在北京上学!	0
那也是为你好啊，有女友吗？	没有，只有男朋友!	0
是	那你现在在做什么工作啊？	0
你多大了？	我22了，我是不是很老了？	0
哦哦嗯	我们一周半天假,然后一天训练,然后两天休息	1
额	你是几年级呢?	0
你觉得情爱是什么？	我觉得爱是一种很奇妙的感觉。	0
你有孩子吗？	没有，我只有一个女儿!	1
对唉	你是90年的吗?	0
是的，你平时不喜欢出去吗？	不喜欢，我喜欢宅在家里!	0
那是浪费。你不能每次都少买一点吗？	我又不知道你喜欢什么!	0
你在哪里工作？	北京，现在在上海，你呢	0
哼	我的书都在家里,我都在学校	0
你喜欢读书吗？	不喜欢，我喜欢睡觉!	0
一个月挣多少钱？	哇,你不是开淘宝店的?那你怎么会知道生意这么好	0
你是哪里人？	我也是河南的啊	0
呦	你这一声呦是什么意思?	0
嗨喽呀	你是做衣服的吗？	0
听着你的口音，你可能是东北人吧？	我是哈尔滨人，在北京工作。	0
呦呵	他说他想结婚，可是我不想!	0
你太棒了。你不怕冷吗？	不怕不怕,我们这里现在还不冷	0
你知道我最喜欢哪个队吗？	不知道!	0
你什么时候上的大学？	16年啊,怎么了	0
你好，你有多高？	不高，只是比你高一点点而已!	0
那你讨厌德云社吗？	不讨厌啊，挺喜欢的!	0
你来自哪个部门？	我来自一个没有人认识我的部门。	0
你现在不工作吗？	嗯，不工作了!	0
哎	怎么了?你也想养一只吗?	0
你知道我8岁是什么时候吗？	不知道，我只知道我喜欢你	0
那你为什么不去呢？你现在忙吗？	不忙啊,我也是刚刚看到的,想试试看的	0
嘤嘤嘤	你是做哪方面的呢？	0
当然可以啦，你为什么这么难受呀？	因为我不知道你是谁呀!	0
你知道我每天什么时候跑步吗？	不知道，我也不知道	0
你的家庭作业怎么样？	我是小学生,你觉得我会写作业吗?	0
你知道我多大了吗？	不知道，你多大了？	0
朋友，你有什么爱好吗？	我喜欢旅游，喜欢摄影，喜欢看电影	0
你知道我最喜欢的球队是什么吗？	不知道,但知道你喜欢火箭	1
嗯呢	你喜欢看啥电影	0
你什么时候休息的？	上午啊!下午啊!晚上啊!	0
我买了什么车？	你不是说你买了本田么	0
今天是星期几？	星期五，你呢？	0
你好，周末愉快。你有什么计划吗？	没有计划，只是想找个人聊聊天而已!	0
你知道我在哪家公司工作吗？	不知道啊!	0
诶	你是学什么专业的？	0
挺好的啦，那你这工作可能不会很闲吧？	还行把,不忙也不是很闲	0
你知道我是哪里人吗？	不知道啊!难道你也是山东?	0
会计在一个月或一个季度的什么时候可以忙碌？	是呀,我在做呀	0
是的，我非常喜欢。我经常听乡村音乐。你没听见吗？	听见了,你还喜欢哪首乡村音乐?	0
那你的工作可能很轻巧吧？	嗯,算是吧,不过也很忙,经常加班	1
你知道谁是这个乐队的主唱吗？	不知道诶，我只听过他们的歌	0
嘤嘤	我要怎么办,我觉得我有抑郁症,我怕我自己	0
好吧，那你空闲时间厌恶干什么呢？	厌恶,厌恶,我也不知道,反正就觉得无聊,想出去转转	0
你讨厌你这份工作吗？	我觉得很压抑,每天上班都是煎熬	0
你也是北方人士吗？	哦,我老家是河南的	0
公司在哪里？	上海徐汇区，徐汇区和浦东大道交口	0
这么多花儿，你是开花店的吗？	不是,这是我家的花池	0
哦呦	老师你在哪里	0
哦哦，我也挺喜欢听音乐的，那你是做什么劳作的呀？	我在网上开了个小店,卖服装的,一个月能挣两三千的生活费吧	0
你是哪里人？	我是北京人，在北京工作!	0
哦哦，那你是住在校园还是住在家里啊？	在家里,学校不允许	0
好！	你是哪个学校的？	0
那你一般讨厌做些什么呢？	讨厌的事多了,最最讨厌的应该就是不喜欢吃胡萝卜	0
哟呵	我在看电视,我妈在打麻将	0
你知道我多大了吗？	不知道，你说吧!	0
啊	你在这里做什么？	0
你知道我什么时候能从中获得灵感吗？	不知道，我也想知道	0
你什么时候回来？	还不知道，不过应该快了	0
你平时吃完饭就在家做事吗？	对啊，我一般都是在家吃饭的。	0
你现在没有工作吗？	我现在还没有工作,我想问问你是不是要找工作?	0
你喜欢看中国嘻哈吗？	不喜欢，我喜欢嘻哈	1
。	你是哪年出生的?	0
我冰箱里有多少种不同口味的咖啡？	不造,没数过	0
你学了多少年？	三年啊,我是三年一贯制	0
你知道我最喜欢哪个城市吗？	不知道，我只知道我在这里等你	0
你好，能和我谈谈吗？	当然，你想聊什么？	0
是的，我非常喜欢电子音乐。你喜欢吗？	我喜欢!但是我不懂音乐!	0
好的，你通常喜欢做什么？	我喜欢做自己喜欢做的事。	0
一个用户有多少分？	那要看你的销量,我的是每月平均2千多分吧	0
你在找什么样的工作？	我现在在找一份自己喜欢的工作!	0
哦对	先把吉他买了	0
他们在一起度过了多少年？	三年多，中间分分合合的，现在又在一起了	0
我喜欢什么样的天气？	你喜欢的我都喜欢	0
我还没想到该怎么办。你的工作是什么？	我的工作就是打杂啊!	0
我什么时候去玩？	随时都可以啊!	0
那你呢？你在做什么？	我在看电视剧，好看吗？	0
负责调查的人叫什么名字？	张小宝张小宝	0
那你都厌恶看什么电影啊？	我都挺喜欢看的	0
很高兴听到你这么说。这部小说一定是改编自电影的，它是？	我也不造是什么,你去百度一下吧,我也没看过小说	0
你每天工作多长时间？	我是做技术的,一天十二个小时,一个月上20天班	0
你知道我喜欢哪种拉面吗？	我知道我知道!	0
你知道谁在看什么吗？	不知道,我只知道我想看第三次	0
你为什么讨厌数学？	因为数学是我的弱项。	0
你想去哪个国家？	不知道，只是想去。	0
是的，他是一只猫，我挺喜欢他的，你讨厌吗？	不讨厌，我很喜欢猫!	0
这为什么会戏言你呢，发型师不是很棒的劳作吗？	我也不知道啊，就是喜欢啊!	0
那我很荣幸，看来我们很无缘，那你平常有什么兴趣爱好呢？	我的兴趣爱好就是看美女呀	0
没什么特别的吗？	那就水煮鱼好了	0
你不是还在学校吗？	对啊,但是我已经不在那个学校了,已经毕业了	0
那你为什么不去呢？你现在忙吗？	我也想去啊,这不是在想吗?	0
你知道我是哪里人吗？	不知道,你是哪的人	0
你想去哪个国家？	还没确定,可能东南亚那边吧	0
我家有几个孩子？	我在北京,如果你想要的话,我可以给你寄	0
你好，请问你这件衣服是在哪卖的？	你好，我也不知道!	0
设计师在哪里？	北京啊，你在北京吗？	0
对嘛	你也喜欢看戏吗？	0
你不喜欢听什么音乐？	不喜欢，不知道为什么。	0
你知道我喜欢什么时候看日出吗？	不知道,但是我想我应该能猜到	0
狗也很干净。你是做什么的？	我是做销售的,你呢?	0
我给自己买了哪栋房子？	写小说啊	0
你知道我喜欢听什么吗？	听你说过啊	0
周末休息两天很好。你是做什么的？	我是做室内设计的。	0
你知道设计师的薪水是多少吗？	不知道,你知道么?给我讲讲呗	0
这工艺太好了。你从事与烹饪相关的行业吗？	是的,我是厨师	0
是的，你非常喜欢冰淇淋吗？	是的，我非常喜爱冰淇淋。	0
我最喜欢的乐队是什么？	最喜欢五月天，最喜欢听他们的歌!	0
你在哪里学习？	我在洛阳上学，现在在郑州工作!	0
嗯	那你有什么事要跟我说吗？	0
嘻嘻嘻	你在干嘛呢？	0
你什么时候要工作？	我现在就在工作啊!	0
对	那我们可以一起跑吗?	0
你知道我从哪里来吗？	不知道啊，你是做什么的呢？	0
你没有什么爱好吗？	没有特别的,我对动漫也不是那么感兴趣	0
我比较喜欢在家里写作，你讨厌写作吗？	不讨厌,就是没那个文笔	0
你家里人不多吗？	不多,三口之家	0
你多大了？	好巧啊,我也22	0
、	我只是个小编剧，没什么大不了的。	0
是啊，你不劳作的时候都干什么呀？	玩手机,睡觉,看电视	0
你为什么压力这么大？怎么搞的？	我也不知道，就是莫名其妙的。	0
饺子在我们哪个地方很常见？	我也不知道，我只知道我们这里的饺子好吃	0
你是哪里人？	是的,我现在在佛山,过几天就回家了	0
呦	你是做哪一行的？	0
你知道我有几个孩子吗？	不知道。	0
我多大了？	你多大了，我也不知道啊!	0
你来自哪个地区？	我是浙江的,哈哈,好远好远	0
你是哪里人？	我是河北人，现在在北京工作!	0
啊？	我的意思是,你唱个歌我听听吧	0
谁的陵墓和国王的陵墓在同一个位置？	我就记得一个西夏王陵,还有两个不记得了	0
嗯嗯，你呢是做什么劳作的？	我是在家带孩子啊,做微商	0
你有什么喜欢的事儿吗？	喜欢你,算吗	0
是吗，你也对稿子有研讨啊？	没有，我只是比较喜欢看书而已。	0
你不是经常有看小说的习惯吗？	是啊，可是我不喜欢看小说。	1
你什么时候不上班？	过两天就不上班了	0
你知道我在这个国家的哪个地方长大吗？	不知道啊!	0
你什么时候休息？	明天休息，后天上班。	0
当然，你还年轻。你在学校吗？	我在北京呢!你在哪个学校？	0
电影里是什么动物？	豹猫?	0
你的伴侣不会担心吗？	我的伴侣都是单身狗啊!	1
你在空闲的时候讨厌干什么呀？	讨厌干啥?讨厌玩手机吧	0
哎	爬山的时候，要注意安全!	0
你知道我最喜欢什么吗？	不知道!	0
你知道我多大了吗？	我不知道你多大，我只知道我比你大	0
~	还好,喜欢看帅哥打篮球	0
你一个月能挣多少元？	3啊,怎么了?	0
你在学校学的是什么专业？	化学工程与工艺，你呢？	0
嗬	你是怎么知道我的名字的？	0
你知道谁是我的偶像吗？	我不知道，我只知道你的名字。	0
你喜欢瑜伽前热身吗？	不喜欢，我喜欢在瑜伽垫上做拉伸。	0
嘛	我爸也不喜欢	0
你知道我在找什么工作吗？	不知道!	0
你不是经常关注新闻吗？	没有啊,我不怎么看新闻的呢	0
病毒传播花了多长时间？	大概一个月左右吧!	0
那你平时厌恶干什么啊？	不知道,没注意过,就是不喜欢	0
我不太明白你的意思。你指的是什么水？	就是自来水,自来水里有氯气,氯气是有害物质,要用纯净水	0
那你们这个劳作也是需要定期培训的吧？	是的，需要的!	0
喔	那你在哪个学校教书呢?	0
你好哥儿们，我们可以聊会儿天吗？	好啊，你喜欢什么样的聊天方式？	0
我喜欢看电影。我最喜欢的电影是《大篷车》。你呢？	那就看点有意思的呗	0
是的，你今天不必工作吗？	不工作,但是要做家务	0
哇哦，那你最厌恶拍人物还是风景呢？	我不太喜欢拍景	0
有多少年了？	两年多吧，在健身房呆了一年多。	0
咳咳咳	你在干嘛呢？	0
你知道我要去哪里旅行吗？	不知道啊!所以问你	0
我多大了？	不知道,不知道你多大,反正肯定比我大	0
你一定很喜欢狗吧？	嗯,家里一堆狗	0
你在店里一个月挣多少钱？	还行吧,还有就是在淘宝上开了个小店,一个月两三千吧,差不多够花了	0
你打算换工作吗？	我是不太想换工作的	0
你知道我什么时候真的喜欢这里的天气吗？	不知道,你说说看	0
是的，你喜欢看综艺节目吗？	嗯,你喜欢看哪些综艺节目?	0
负责孩子责任的人叫什么名字？	叫小二，因为小二是我的名字!	0
你知道我最好的朋友来自哪里吗？	不知道!	0
补贴的最低年龄是多少岁？	我也不知道,我还想知道补助是多少钱呢	0
我喜欢扮演荣耀之王。你也喜欢玩游戏吗？	不喜欢,玩过几天,不爱玩	0
你为什么这么认为？	因为我觉得你很可爱呀!	0
啊，这不是件小事吗？	是的，是的，小事，小事!	0
你知道青岛在哪个省吗？	山东省啊	0
你从土木工程专业毕业花了多少年时间？	本科四年,研究生三年啊,怎么了?	0
你所在的国家叫什么名字？	我现在在缅甸	0
哇哦	有机会一起去滑雪吧	0
她也喜欢，那我们带点玩具过去吧，你厌烦玩什么？	我也不知道我烦什么,你们玩什么我就玩什么	0
对了	你在哪儿看的啊？	0
啊啊	真的,我妈妈一直这样说	0
你知道我特别喜欢谁吗？	不知道!	0
你知道我星期几上学吗？	不知道,星期六还是星期天呢?	0
我对钢琴知之甚少。你钢琴弹得不好吗？	我弹得很烂，你会弹吗？	0
坏啊！你最近厌烦干什么？	看书,听歌,看电影	0
对对对	那你现在在干嘛呢？	0
嗨喽	嗨,还不休息啊	0
你不是还在上大学吗？	是啊，我还没毕业呢!	0
嗯嗯，你呢，你空余日子都喜欢做什么啊？	画画，弹琴，弹吉他，看书。	0
这也很好。你在家做什么？	什么都不做啊,在家里就睡觉玩手机啊,还能干什么	0
嗨喽	嗨喽，你也是吗？	0
我喜欢钓鱼和做鱼。我是美食家。你呢？	我也喜欢,就是不会做鱼	0
电影里是什么动物？	不知道,我没看过,只听过	0
你什么时候睡得好？	我也不知道，有时候睡的很好	0
你从哪里来的？	我从河南来的,你呢	0
好啊	那,你的,网,点,怎,么做的啊,可以留个扣,扣,教,教我吗?	0
锻炼对你的健康有益。你通常做什么？	跑步,散步,打羽毛球,仰卧起坐	0
那你会很不舒服。你太累了，工作太多，睡眠太少。你的身体能忍受吗？	应该能吧!	0
你知道菊花在什么季节开放吗？	我不知道,你要告诉我么?	0
你现在是学生了吗？	不是,我是做微商的	0
你去过海南吗？	去过海南,但也不是很熟悉,因为我不是海南人	0
你知道我的两个孩子多大了吗？	我不知道，你知道吗？	0
呃，好吧，不过像大米饭或者面这些主食品你应该不会也拒绝吧？	嗯,也拒绝,一口也不吃	0
你能每天都这样睡觉吗？	这个问题问得好，我也不知道	0
你有几个女儿？	一个，还有一个。	1
那挺好的，那你做事的时候讨厌做什么呢？	什么都不讨厌啊,我觉得都挺好啊	0
是哦	我现在在外面旅游,回去给你写	0
他在哪里？	杭州啊，你不知道吗？	0
你为什么讨厌数学？	因为我数学很差，所以不喜欢。	0
那很好。你没钓过鱼吗？	没有，我都是去河里钓的。	1
喔	你是学设计的吗?	0
你知道我什么时候和朋友去远足吗？	我也不知道，我也没去过远足	0
你知道我是哪里人吗？	不晓得啊,你是哪里的?	0
对嗯	我现在在床上躺着,不想动	0
我们别谈这个。你最近在做什么？	我啊，就在公司上班啊!	0
你一个月工资很高吗？	我没工资,啃老	0
谢谢，卫生工作者真的很伟大，有时候劳作也挺忙的，你有什么爱好吗？	我喜欢睡觉，不喜欢工作。	0
呜呜呜	怎么了,哭啥呢	0
你知道我所在的树叫什么名字吗？	不知道，我只知道你叫李子树	0
你不喜欢什么样的工作？	我不喜欢工作，我喜欢做自己喜欢的事!	0
你也是北方人士吗？	我是西北人,在山东	0
你知道我什么时候是大一新生吗？	不知道，我也是新生	0
你知道我开始练习的时候多大了吗？	不知道,反正我从小就会了	0
这项工作是在哪里完成的？	在学校的时候,在天津	0
你什么时候感觉好些？	昨天就好很多了	0
你也不喜欢听摇滚乐吗？	不喜欢，我喜欢朋克!	0
你什么时候要工作？	下个月吧,怎么了?你有好的介绍?	0
没关系。你喜欢画什么？	不知道,我只喜欢看	0
你好，你今天上班吗？	不上,在家呢	0
除了汽车，你没有其他爱好吗？	没有，我喜欢的东西太杂了。	1
你工作了多少年？	我工作3年半了,今年是第四年,你工作多少年了?	0
唉	那他为什么不喜欢你呢?	0
你多大了？	我是89年的，比你大一点!	0
噢噢	你们在市里哪一块?	0
？？？	你说的是一位演员吧	0
你知道我是哪里人吗？	不知道啊,我只知道你是南疆的	0
你要吃的茶叫什么名字？	我也不知道,我就知道是绿茶	0
可以呀	你加我微信呀还是我加你呀?	0
哪个年龄组最大？	不知道,我也才加入	0
你知道我多大的时候开始跳舞吗？	不知道,但我知道我现在也不小了	0
你知道她的国籍是什么吗？	哈萨克斯坦?我不知道,我只知道她是中国人	1
你有多少钱？	不多，就几十块钱而已	0
我的家人来自哪个国家？	来自中国	0
大一是哪一年？	大一就是刚高考完的一年	0
你是自己想学的舞，还是你家人选替你选的？	我学的，他们也帮我选了。	0
你叫谁？	我叫詹姆斯	0
你喜欢什么类型的电影？	什么类型都喜欢啊	0
哇，很好。你忙吗？	忙啊，不过不忙的时候就想找你聊天	0
你上的大学叫什么名字？	你想多了,我上的是高中	0
你是哪里人？	我是广东的，你呢？	0
自从服用避孕药以来，你瘦了多少公斤？	10斤啊,我从去年6月到现在没吃过了,我就想快点减肥	0
好的，那你的工作闲吗？	我的工作比较轻松,一般一天也就上六个小时的班,所以比较自由	0
哇，你真棒。你有什么奖励吗？	你想要什么呢？	0
我喜欢购物，经常出去吃饭。你喜欢购物吗？	喜欢吃饭逛街,不喜欢出去吃	0
你平时厌烦干什么？	不知道,感觉没什么可以让我厌烦的,就是无聊	0
对嗯	你喜欢看什么电影？	0
你不喜欢做什么？	你说的这些都是很好的习惯	0
你知道我喜欢什么系列的漫画书吗？	不知道啊我又不认识你	0
你这么早就去上班？	是啊，没办法啊!	0
所以你从小就住在青岛，不是吗？你现在在青岛工作吗？	我在青岛上学,今年毕业,现在在实习	0
你知道我有多少工作吗？	不知道,加油站我觉得好幸苦	0
没有没有，你在哪劳作呢？	我在深圳呢,你呢?	0
你知道我有几条狗吗？	不知道，我只知道你有好多狗!	0
你想去哪个国家？	还没确定下来,主要是想先去云南	0
噗	你这两个字是在笑吗?	0
92年你多大了？	我91年的，应该比你大吧!	0
我也不想这么做。我别无选择，只能忍受。别提我！你每天怎么节食？	我没节食啊!只是少吃而已!	0
是的，除了注意健康，你没有什么爱好吗？	有很多啊,运动,看书,听歌,等等	0
那你为什么不喜欢这些户外运动呢？	为什么要喜欢呢	0
你知道我是哪个队的教练吗？	不知道。	0
你知道我儿子多大了吗？	我知道你儿子大概有多少岁。	0
哇呜	你是做什么的,我也想换工作,但是又有很多问题需要解决	0
你好，能来接我吗？	你在哪个校区？	0
你叫我兄弟。你很小的时候玩手机？	是的，很小就开始玩了!	0
对对	你是一只可爱的小猫咪吗	0
你知道青岛在哪个省吗？	当然知道,我就是青岛的啊	0
你藏了一首谁的歌？	我喜欢陈奕迅,所以有他的歌	0
你有多少只猫？	两只，还有一只是英短，一只是美短。	1
什么时候？	你是说什么时候上班吗	0
一个典型的网店员工的收入是多少？	那我哪知道,你自己去问呗	0
你知道我喜欢去做什么吗？	我知道，你喜欢去吃好吃的!	0
你知道我最喜欢的电影是什么吗？	不知道,说说呗	0
你知道3号床的儿子的病房号是多少吗？	我也不知道,我只是一名护士	0
你知道我有多少只猫吗？	不知道,反正你很酷	0
哦哦	你是哪里人啊？	0
你的朋友会对你评价不好吗？	不会，她们都是很好的人!	0
你的家在哪里？	我在北京工作，现在在北京上学!	1
你什么时候毕业的？	我是13年7月份毕业	0
是啊，我就是这么以为的啊，没有学习者你们去院校干嘛？	我们去玩啊!你不知道吗？	0
你知道我喜欢听什么管弦乐队吗？	不知道啊,我就知道一个贝多芬	0
你多大了？	我才19,家里人催,我也很绝望	0
你知道我去过哪个国家吗？	不知道，你说说看	0
好的，你现在在工作吗？	没有呢,准备过段时间出去找工作	0
休息时给自己冲杯咖啡。你的工作不是很简单吗？	我的工作很简单，只是不想做而已。	0
对嘛	你是做什么行业的,我看看我能不能做	0
你知道我多大了吗？	知道,比我大一岁	0
大三学生的职称是什么？	什么职称?	0
我开始玩的时候多大了？	不晓得,反正比我晚	0
我们东北人士说话都是这样我来自黑龙江你是哪里的？	我是辽宁的，在大连上学!	0
你丈夫在干什么？	他在写一本关于男人的书	0
你知道我接触芭蕾舞已有多少年了吗？	我只知道我从3岁开始接触芭蕾,一直到现在我都没忘记这个舞蹈	0
我也喜欢芭比娃娃，我没学过箜篌，你学过吗？	没有。我学的是电子琴。	0
你不玩什么游戏？	我不玩游戏,只看动漫	0
嗯对呀	我也差不多这个点上班,不过我是下午班	0
你知道我最喜欢的节日是什么吗？	国庆节啊,你想什么呢	0
是啊，看你穿的运动服，是去体操房了吗？	不是啊,自己买的运动装啊	0
她有多少只猫？	不知道，我只知道她有三只!	1
你知道我特别喜欢哪个魔术师吗？	约翰塞纳	0
太好了。你有什么爱好吗？	我的爱好就是看书，旅行，看书!	0
你妹妹喜欢跳舞吗？	不喜欢她说她喜欢打游戏	0
海洋生物学家有一个很好的方向。你的专业是生物学？	我的是生物医学工程专业,不是学这个专业的	0
你知道因为狗我遇到了哪位妻子吗？	第几任	0
你知道我的身体有多高吗？	我不知道,不过你要想参加街舞社也行,我帮你问问	0
你知道我住在哪个县吗？	你是哪个县?	0
哇讨厌摩托车呀？	喜欢摩托车,更喜欢你	0
可以啊，我是一名学习者，你呢？	我也是啊,你是大几的?	0
你知道我特别喜欢谁吗？	不知道，我只知道你很喜欢他!	0
我的学校在大兴。你已经工作了吗？	没有,还在读研	0
嗯	你在哪?多大啦	0
我孩子的孩子多大了？	你的孩子还没出生呢。	0
诶呀	你呢?在上班?	0
你很厌恶写作吗？	厌恶?	0
你知道我有几条狗吗？	不知道,我想看	0
我什么时候看电视新闻？	我在开玩笑的,我知道你不看的	0
你在哪个联赛打得不好？	哪个联赛也没打过	0
太好了。你毕业后不是在找生物学的工作吗？	是的，我已经找到工作了。	0
你什么时候毕业的？	我去年毕业的，今年刚考上大学。	0
呗	你在哪里上班的?	0
啊，你明白。你还是学生吗？	哦哦,好吧,那你是老师喽?	0
那你是不是特别嫉妒人家老婆？	嗯,你咋知道的,我嫉妒她老公	1
我叫王兵。嘿，你吃晚饭了吗？	还没呢，你在哪儿呢？	0
那你想换一个劳作吗？	不想，太累了!	0
哦哦嗯	你呢你呢,我猜你应该是初中	0
对对	那你平时是一个注重保养,注重美容的女生喽	0
你知道我来自哪个城市吗？	不知道啊!	0
你好你今天好吗？	我今天很好，谢谢你的关心!	0
对啊呀	那你喜欢做什么呢？	0
你知道我是哪里人吗？	不知道，你是哪儿的？	0
我有多少只猫？	你有多少个猫？	0
你竟然还玩滑板，你是一个在校生吗？	不是啊,早毕业了	0
哎呦	你说你想离婚,你老公同意吗?	0
你知道《傲慢与偏见》的作者叫什么名字吗？	不知道啊!	0
他妻子多大了？	我俩都是82年的	0
你忙了几天？	今天第二天,	0
我更喜欢包饺子，尤其是蘑菇馅的饺子。下班后你喜欢做什么？	我也喜欢吃蘑菇馅!	0
你是联佳的房地产销售人员。你通常有工作量吗？	我不是销售，我是卖房子的。	0
你是哪里人？	我是广东人，现在在深圳工作!	0
啦啦啦	你种的菜能不能吃啊?	0
你知道我儿子多大了吗？	不知道，你告诉我吧!	0
你不觉得你的生活很无聊吗？	我的生活也很无聊啊!	0
你有几条狗？	我有一只阿拉斯加一只金毛	0
你知道哪种拉面味道很浓吗？	不知道，我只知道兰州牛肉面	0
对对对	你家的狗狗是啥品种的	0
你推荐的学校叫什么名字？	湖北第二师范,湖北科技学院,湖北工程学院,武汉纺织学院	0
你喜欢听谁的歌？	五月天!	0
你知道我最喜欢的季节是什么吗？	我不知道你最喜欢什么季节!	0
你很久没写这篇文章了吗？	最近都没时间,有时间了我会写的	0
这样，那你现在一定很有趣吧？	我现在很无趣	0
你在哪个联赛打得不好？	我不知道啊!我都不怎么会玩	0
你知道贵阳在哪里吗？	不知道，我是土生土长的贵阳人	1
你是瑜伽老师吗？	不是，只是爱好而已	0
你现在做什么？	还是外贸啊,做了两年了	0
那你比我小，你教的什么专业呀？	我教的是财务管理，你呢	0
你知道我多大了吗？	不是20吗?	0
你知道医护人员通常在一天中的什么时间工作吗？	不知道，我只知道他们的工作时间是固定的。	0
什么时候发生？	还不知道呢!	0
太好了。你知道什么有趣的地方吗？	不清楚了,我都好多年没出去了	0
你好呀，你平时厌烦游泳吗？	不厌烦,但我觉得我游得不好	0
该地区大多数人的年龄范围是多少？	这个我没注意过啊,反正我在这感觉都是年轻人	0
你知道我是哪里人吗？	不知道啊!你是山西哪里的？	1
喂	我很好，你呢？	0
你能告诉我最近哪只股票潜力最大吗？	不知道，我只知道我的潜力是最大的。	0
我也是。你现在是工作还是上学？	上班了，不过还没找到工作。	1
你能演奏什么乐器？	吉他，贝斯，吉他，鼓，都可以。	0
嗨	你现在是在哪里的呀?	0
摇滚乐，你非常喜欢摇滚乐吗？	也不是,只是听习惯了,听别的不舒服	0
嗯啊	那你现在是在哪家单位工作呢?	0
你多大了？	好吧,我是小妹妹	0
哦呦	那你请我吃什么呢？	0
你的大学入学考试怎么样？你不能进入你最喜欢的大学吗？	考的还行,可以去自己喜欢的专业	0
你知道我背上有多少个纹身吗？	不造啊,几个?	0
你知道我多大了吗？	28岁,是不?	0
喏	我也不知道该说什么，就这样吧。	0
你好，请问附近有图书馆吗？	有图书室,没有图书馆	0
我通常更喜欢听音乐。你喜欢音乐吗？	我喜欢听歌，也喜欢看电影。	0
你家有多少只仓鼠？	一只啊,一只布丁一只紫仓	1
你好，你是哪儿人氏？	我是安徽人,你在北京做什么?	0
你好，我叫赵武。你叫什么名字？	我叫赵子龙，这是我的名片。	0
好吧，我回来后再看。你是做什么的？	我是做建筑设计的,呵呵	0
你知道我被带去相亲的时候多大了吗？	不知道，我也是被带去的。	0
你不玩什么游戏？	不玩的,我不玩游戏的	0
比赛日期是什么时候？	9.11号上午九点开始	0
你知道我在哪里买的房子吗？	在哪里,你告诉我呀,你说	0
你知道我多大了吗？	不知道,我就随便说的	0
你知道我几岁开始学习音乐吗？	不知道,你几岁学的	0
哪里天气好？	哪里天气都不错	0
你好，你讨厌干什么呀？	你好,我讨厌别人说我胖	0
开学的第一天是星期几？	星期五,我星期五下午就要去	0
哇，那么你应该有个好身材？	我也不知道是好还是不好,哈哈	0
我在医院当档案管理员。你平时忙吗？	忙啊，忙的时候忙死，闲的时候闲死。	0
爱上你的人叫什么名字？	叫杨洋	0
那你都喜欢哪个流行乐演唱者啊？	苏打绿，梁静茹，孙燕姿	0
我没有多少精力去培养自己的爱好，就比较喜欢打扫卫生和做饭，我做的米饭很好吃的，你呢？	我只会做饭,不会打扫卫生	0
你知道我生的第一个孩子叫什么名字吗？	叫什么?你说吧	0
好！	我也是大四的,我是大四实习狗,你呢?	0
对了	你是哪个学校啊？	0
…	烦躁是因为你没男朋友	0
噢	你有车,你厉害,你开宝马奔驰	0
我喜欢在业余时间读小说书，尤其是窃密问题的小说书，我觉得这类的小说书很好看，还有就是我会在业余时间打网球，你呢？	我喜欢在网上看悬疑类的小说,我觉得这类的小说书很好看,还有就是你呢	0
你知道我现在开的车是什么吗？	不知道，你说说看	0
你白天什么时候起床感到困倦？	我都是睡到中午12点	0
你为什么这么忙？	我也不知道,就是很忙啊	0
你现在在干什么？	我现在在工作啊，你是做什么的啊？	0
那很好。顺便问一下，你是大学生吗？	是啊是啊,我现在在读大一	0
怎么了你无聊吗？	是啊,你有什么好玩的吗	0
你在哪里学习？	我在长沙上学，现在在武汉工作!	0
你好，我来自中国东北。你从哪里来的？	我是中国山东的	0
对嘛	你有没有好的项目啊?	0
对，我14岁了，在上初中，你也是学习者吗？	是的，我是学美术的。	0
你推荐的学校叫什么名字？	我看的是武汉生物工程学院和湖北经济学院	0
就这么定了。你是做什么的？	我也做设计的,我是学平面设计的,你呢?	0
你的种族是什么？	不知道,应该是汉族吧	0
我是女生，你是工读生还是女生呢？	工读生是什么意思?	0
嗨，你有机会见到你吗？	当然有啊!	0
谁是中国流行歌手？	不知道，只知道她的歌很好听	1
你知道我开始练习的时候多大了吗？	我不知道我只知道我的人生就是在打台球中度过	0
你现在不工作吗？	是啊，我在上班啊!	1
你是什么人？	我是你的粉丝，你是我的粉丝吗？	0
你好，你忙吗？	不忙，你呢？	0
你知道我喜欢谁吗？	不知道，你喜欢谁？	0
你知道我喜欢读谁的书吗？	不知道，我只知道你喜欢看书!	0
你唯一喜欢的饮料是什么？	矿泉水,白开水	0
你好，你有多高？	比你高一点，也就一米七吧!	0
哦，你通常喜欢做什么？	喜欢的话,就开个网店啊,赚点生活费什么的	0
你住在哪里？	我住在虹口区，你呢	0
你知道我最喜欢什么吗？	你喜欢什么,我怎么知道	0
我也对自动驾驶感兴趣。你有什么样的车？	我没有，我只有一台自动挡的车!	1
很好。我也有自己的爱好。你跳什么舞？	爵士，hiphop，爵士舞都可以	0
哇喔	起来了,准备洗漱了	0
摇滚乐，你非常喜欢摇滚乐吗？	还好吧,我也不知道怎么才算是喜欢,不过我觉得好听的歌我都听过	0
为什么对你来说这么大？	因为我的床是大的呀	0
喝啊	不喝酒的,我也不抽烟	0
嘻	在干嘛呢?上班还是休息啊?	0
这个月你用了多少天？	这个月我还没休呢	0
你以前学过法律吗？	没有，我是理科生，只是喜欢看书	0
你为什么这么忙？	因为我有工作啊	0
我去过哪个城市？	你来过江苏哪里?	0
你在哪里学习？	我在湖北工业大学，你是哪个学校的？	0
谁毕业于勘萨斯大学？	不知道,我毕业于堪萨斯大学	1
哎	你也养狗啊?	0
除了西藏和四川，你还想去什么地方？	我想去的地方挺多的,最想先去西藏	0
哇，你真棒。你的专业是什么？	我学的不是这个专业，我学的平面设计	0
嗨喽	嗨喽，你在干嘛呢？	0
你知道我是哪里人吗？	不知道啊，你不是河南的吗？	1
到机场花了多长时间？	两个多小时。	0
哇，很好。你忙吗？	不忙，只是很忙!	1
会给你带来麻烦吗？	不会麻烦的	0
你知道我什么时候有女儿吗？	你不是有女儿么	0
你从事销售工作有多少年了？	我从事销售有三年多了,销售很锻炼人,很磨练人,你可以尝试一下	0
你知道我母亲的国籍是什么吗？	不知道，你能告诉我吗？	0
你是哪里人？	我是江苏人，现在在上海工作!	0
你什么时候毕业的？	12年,你呢	0
你好你现在正在做什么？	我在回家的路上，马上就到家了!	0
你不会弹吉他吗？	不会，我只会弹《小星星》	1
三年级的学生人数是多少？	我不知道，我教的是五年级。	0
嘿，你是做什么的？	我是做设计的呀,嘿嘿,你是做什么的呀?	0
原来是这样啊，那你工作可能挺忙的吧？	还好，还好!	0
哎	你是哪个城市的？	0
好吧，我没有太多时间锻炼。你从哪里来的？	我是成都的，现在在成都工作!	0
你妈妈在图书馆劳作吗？	不劳作啊,就是看书啊	0
你工作时经常在哪里吃饭？	我还没工作啊,我才大四	0
是的，你喜欢看综艺节目吗？	你有什么推荐吗,我看的比较少,你呢?	0
你知道谁是最富有的人吗？	我不知道,所以才问你	0
你知道我喜欢谁的书吗？	不知道，只知道你喜欢看书!	0
你知道我几乎每年什么时候去动物园吗？	我知道，我也是!	0
翻译这么好的劳作，你竟然丢了？	说多都是累啊	0
这个问题的答案是什么？	什么什么答案	0
你通常不喜欢做什么？	不喜欢睡觉，喜欢发呆	0
你什么时候出去？	现在就在外面玩，明天就回去了	0
是的，我是养蜂人。你不喜欢蜂蜜吗？	不喜欢，我不喜欢喝蜂蜜。	0
你喜欢吃寿司呀，讨厌吃哪种口味的寿司呢？	喜欢吃啊,不知道讨厌哪种,没吃过几次	0
哦哦，你是新找劳作的吗？	嗯,新找的工作	0
还有，在玉米收获季节，你们家会种多少小麦？	这个我就不知道了。	0
学生在哪里？	在上海，你呢？	0
我也很高兴见到你。你今天有工作吗？	有啊，今天是我的生日。	0
你想出去吗？	想,就是不想一个人出去	0
那太谢谢你，你去牙齿保健室也是去看牙齿的吗？	是的，我们都是去的牙科诊所	0
在杭州，我们公司仍有光明的未来。你不想来杭州发展吗？	我想啊，可是我不认识路啊。	0
你知道贵阳在哪里吗？	不知道，我只知道贵州是个好地方	0
你知道我训练过多少种动物吗？	不清楚,但你应该是个有耐心的人	0
你知道我练空手道花了多长时间吗？	不知道,你说啊	0
哇啊，你好有酒兴啊，你平常在哪钓鱼啊？	我一般在家里钓的，你是哪里的？	0
哈哈~	教我嘛,我想学	0
你什么时候休息？	我休息的时候你也休息啊!	0
世界排名是什么？	排名不重要，重要的是你的态度。	0
你知道我一周有多少次表现出色吗？	不知道，我也不知道!	0
你知道我的家人住在哪里吗？	不知道,我是看到你上面说的,我才问你的	0
不错不错，那你还喜欢干别的事吗，在闲的无聊的时候？	我喜欢睡觉，上网，看书，睡觉。	0
除了音乐你还做什么？	我还在上学，还在学校。	0
你知道我是哪里人吗？	青岛,对吧	0
嗯嗯，你最讨厌的小说是哪篇啊？	我也都很喜欢啊	0
你知道我不喜欢什么样的天气吗？	不知道!	0
世界上大多数人的年龄范围是多少？	20到30岁之间吧!	0
你不表演的时候会做什么？	看书，听音乐，喝咖啡，看书	0
你非常喜欢烹饪吗？	是的，我很喜欢。	0
！！！	是啊!你不知道吗？	0
你来自中国东北的哪个省？	我是吉林省的,但是你这个问题我还真不知道	1
你通常喜欢做什么运动？	我喜欢游泳和羽毛球。	0
我来自北京。你喜欢狗吗？	喜欢啊!超喜欢的!	0
喝啊	喝什么？	0
你知道我在电影院工作了多少年吗？	有20多年了吗	0
你在哪个国家？	纽约州	0
我真的很想成为你的朋友。我想和你一起玩，好吗？	好啊,我最喜欢和美女一起玩耍了	0
你有多可爱？	比你还可爱	0
你在哪里教书？	我在一中呢	0
哎呦	你是来买花的吗?	0
我在看书。你喜欢读书吗？	喜欢啊!你在哪里读书啊？	0
谁写了《夏洛克·福尔摩斯》？	不知道啊，我只知道他的书都很好看	0
我没有多少精力去培养自己的爱好，就比较喜欢打扫卫生和做饭，我做的米饭很好吃的，你呢？	你做了给我寄过来吗	0
你在家里对他做什么？	我不知道，我不喜欢他。	0
看你在这画画的这么认真，头颅都不抬，你很喜欢画画吗？	是的，很喜欢。	0
你知道我父亲去世时多大了吗？	不知道。	0
你开的车叫什么名字？	你问我这个干嘛?有什么目的	0
你知道我通常什么时候吃一个苹果吗？	不吃早饭的时候吃	0
哈咯啊	请问有没有电话啊我不在学校	0
我现在很忙。我能和你谈谈吗？	可以啊!	0
你有没有想过为你的孩子再找一个父亲？	没有,你自己好好想想吧	0
还是算了吧，我不太喜欢喝酒，我比较喜欢玩RPG电脑游戏，你呢，你讨厌游戏吗？	我也喜欢游戏,我是玩英雄联盟的,你玩吗?	0
你好，你喜欢聊天吗？	我不喜欢，我只喜欢和你聊天	1
你知道我有多少只猫吗？	我不知道,你是卖宠物的?	0
你平时厌烦干什么？	我没有讨厌的,除了学习,玩游戏,就是看电视玩手机	0
你多大了？	我比你小一岁。你呢？	0
不错嘛，听样子你是每个周五都会回吗？	不一定吧,有时间的话,就回	0
嗯嗯嗯	我也是黄金，可以一起玩吗？	0
这孩子多大了？	不知道，大概两岁多吧!	0
那你有没有找到劳作呢？	没有，我都不知道自己要做什么!	0
你一个月能挣多少元？	你一个月能挣多少?我也想开一个网店就是不知道该怎么做?	0
你猜疑有外星人吗？	我不猜疑,我坚信有奥特曼就一定有外星人	0
是的，我以前去过蹦极。你没玩过蹦极吗？	没有，恐高的人不敢去!	0
你和你的爱人是怎么认识的？	我们是一个学校的,然后就认识了	0
呦	你觉得没意思啊	0
你学什么语言？	西班牙文，你呢？	0
我居住的国家叫什么名字？	我也不知道!	0
你知道我有多少只猫吗？	不知道，我只知道你有一只猫咪!	0
哦，你平时厌恶做什么？	厌恶我讨厌的人	0
最近打算先找劳作吧，在家也好多天了，对了，你会做饭吗？	你这是啥意思啊,怎么都问我这个问题	0
是的，你没有家人吗？	有啊,不过不在一个城市里	0
是的，你喜欢做什么？	我喜欢发呆，看书，听歌，	0
你猜对了吗？	对啊!你是哪位啊	0
到了吗？	嗯哼,到了,谢谢你,么么哒	0
我的车是大众帕萨特。你也会有自己的车。你喜欢做什么？	我喜欢旅行，看书，旅行，旅游。	0
？？？	你是说我跑的非常慢了?	0
你同事给你起的绰号？	没有同事啊	0
律师在哪？	北京，北京律师事务所。	0
好的，你现在是在上学还是已经劳作了？	我已经毕业了，现在在上班!	0
你知道我最喜欢的语言是什么吗？	法语?	0
那很好。你没钓过鱼吗？	没有，我不喜欢吃鱼。	0
你第一次到这样的地方是什么时候？	我是去年暑假去的，那时候还没有烤玉米呢	0
不怎么爱说话，你可以教教我怎么和局外人沟通吗？	我不会和局外人说话,我不喜欢和陌生人说话	0
负责调查的人叫什么名字？	我叫小莉，你叫我小丽就可以了。	1
演出将持续几天？	不知道啊，到时候看情况吧!	0
你知道我多大了吗？	你不是说你才20岁么	0
你知道我有几条狗吗？	不知道!	0
你知道我更喜欢哪个乐队吗？	不知道!	0
你经常锻炼吗？	嗯,经常锻炼	0
我六岁的时候？	是的，你应该比我大吧？	0
谁是鼓手？	你呀，你不是鼓手吗？	0
你好呀，可以答你个问题吗？	可以啊，你问吧!	0
你喜欢什么？	说唱!	0
嗨喽呀	我还以为你还没写完,所以我就没打扰你	0
你这些天都在做什么？	上班啊，下班啊，吃饭啊，睡觉啊!	0
你看了什么电视剧？	还没看呢，我在看快乐大本营	0
这是我的第一份劳作，我肯定会好好努力的，你是哪里的？	我老家湖北的,不过在深圳工作呢	0
负责调查的人叫什么名字？	我叫王飞，你是哪个部门的？	0
。	好吧，那你想聊什么？	0
你多大了？	我今年刚满26岁，比你大一点!	0
你知道你见过这些生物吗吗？	我不知道，你知道吗？	0
负责调查的人叫什么名字？	我叫王雨飞，你的名字呢？	0
你怎么在家劳作这么自由呀？	是很自由啊,不过我的生活很单调,没有钱也没工作	0
呗	我喜欢跳现代舞	0
你知道我多大了吗？	不知道!但是我知道你比我小!	0
你有没有想过如果失败了该怎么办？	我不知道，我只知道我不想再失败了	0
我多大了？	你猜。	0
我也觉得很幸运。你通常喜欢去哪里？	我喜欢安静的地方。	0
你失业了吗？	没有啊，我还没毕业呢!	0
嗨	嗨!我洛阳的	0
那你这些天都不能上班了，不是吗？	是的，可是我还有很多工作要做。	0
我最近一直在学英语。你多大了？	我是女生,我19了	0
诶呀	你是男的还是女的？	0
你知道我有几条狗吗？	不知道诶,你养了几条?	0
你不是经常在公园里散步吗？	是啊，可是我不知道你在这里	0
你什么时候上班？	今天上午就上班了，你呢	0
恭喜你啊，什么车辆呀？	谢谢，是大众途观l	0
你知道我打英雄联盟有多少年了吗？	不知道,你说出来啊	0
哇呜	在家,我妈不让我出去	0
没有，我在家照顾孩子，没法出去上班，你放工了呀？	嗯,放假了,你也快放假了吧?	0
能考上大学就代表你很聪明呀，怎么会学不出来呢？	我真的很笨，你相信我好吗？	0
这只小鸟多大了？	我也不知道，大概10岁左右吧	0
你是很讨厌网购吗？	不是讨厌，只是不喜欢!	0
是的，我就是这个意思。你高中毕业了吗？	毕业了,我今年毕业的	0
什么能让你这么难过？	感情的事,哎	0
你以前没上网吗？	没有啊，我都是用手机上的	1
你在哪？	北京啊，你在哪儿呢？	0
你多大了？	你还年轻,我比你大一岁	0
你和朋友出去吗？	偶尔也会,不过不多	0
你知道我祖母是哪里人吗？	不知道，祖母是河南哪里的？	1
你为啥要学法规呀？	因为我是会计专业的，所以要考这个	0
是的，你还在上学还是在工作？	我已经毕业了，现在在上班了!	0
你知道我有多高吗？	你一米六二	0
晚上好你还没休息吗？	是啊，明天还要上班呢!	0
你的惩罚是什么？	罚他们站军姿两个小时	0
嗯？	你是做哪方面的	0
如果你愿意，你可以加入我们！我们明天有活动。我们打算绕着湖散步。你不想来吗？	你们几点开始啊?	0
你知道我多大了吗？	我以为你跟我差不多大	0
你知道我更喜欢什么季节吗？	不知道!我只知道冬天有雪!	0
你还在工作还是在学校？	我也是大二的,在哪上学啊	0
你通常什么时候跑步？	晚上7点到8点之间	0
嘻哈	哈哈,是的,你呢?	0
那个叫小英的人叫什么名字？	小英啊!你怎么会不知道呢？	0
你是哪里人？	我是湖南人，在北京上学!	0
噢	那你喜欢什么样的人呢？	0
？？？	喜欢打但是打的不好	0
你知道学校什么时候开学吗？	不知道啊!	0
你什么时候回去？	明天下午就回去了，你呢？	0
你知道一个不折不扣的北京人是什么意思吗？	不知道，我只知道我在北京活着	0
你知道我从哪里来吗？	不知道啊，你在哪里教书呢？	0
你知道我最喜欢哪部电影吗？	你不说我怎么知道?	0
对嘛	没钱,没经验,没关系,没人脉,就不要去经商,这是我的经验	0
你开始写作有几个月了？	差不多三个月吧	0
这对夫妇的女儿多大了？	一岁零四个月了	0
不过这个大学不是很好考，你有信念吗？	我有信念,我也相信自己能考上,就是不知道难不难考?	0
你有几个孩子？	两个，一个弟弟，一个妹妹	0
你还在上小学。你为什么不在这里学习聊天呢？	因为我在上小学呀	0
但你真的不努力学习吗？	我是个很不努力的人	0
对	我也害怕,我怕撞人,害怕车撞人	0
那你这个劳作也挺好的呀，为什么刚刚要那么说呢？	因为刚才看到一个帖子，说是这样的。	0
那收藏泰迪熊也是一笔不小的花销啊，你做卫生员的工资够吗？	这个就不知道了。	0
大三学生的班号是多少？	我在学校的时候没有班号这一说,只有年级,你问我年级就好了	0
看来你是真的很喜欢当老师呀，你平时业余时间都讨厌做什么？	做唰单	0
那时候你玩什么游戏？	我不喜欢玩游戏，我喜欢看别人玩	0
你知道我什么时候开始学习的吗？	不知道。	0
你知道我所在的树叫什么名字吗？	不是李子树吗	0
你还在上小学。你为什么不在这里学习聊天呢？	你在说什么啊!我听不懂啊	0
那你有喜欢的羽毛球明星吗？	没有，我不喜欢运动员。	0
那你都不去劳作的吗？	我只是在上班而已啊!	0
有多少段？	我也不知道，我还没上去呢!	0
公司在哪里？	上海徐汇区，高德置地广场附近	0
你在哪里？	我在广州啊,你呢?	0
你知道我什么时候和朋友去潜水吗？	这个不知道，我也是旱鸭子	0
你多大了？	我都23了，你应该比我大吧？	0
这是我的第一份劳作，我肯定会好好努力的，你是哪里的？	嗯嗯,加油,我是四川的,不过在深圳待了10年啦	0
你的公司没有安排你的出差吗？	没有，我的公司不需要出差!	0
对呀，我几乎每周都会吃一次，你有什么厌烦的食物吗？	我不挑食，只要是好吃的我都喜欢!	0
你和你友人们出去玩，难道你不用劳作吗？	要,但是我可以选择不玩,玩就好好玩	0
你有谁的签名？	我自己啊，我的名字是我自己起的。	0
生活费需要多少钱？	哇,这么多,学姐可以教教我吗	0
你知道舞蹈编舞的人叫什么名字吗？	不知道，你知道吗？	0
~	你是有心事,才睡得早吧	0
你现在有时间学习吗？	有啊,我大三,还有一个学期时间	0
和我一样的人在哪里结婚的？	在韩国啊	0
你一周玩几个小时？	我一个月才玩2小时	0
现在是哪一年？	现在是2012年，我是不是很老了？	1
哇，我真佩服你。你通常喜欢做什么？	我喜欢看书，看电影，看书!	0
嗷	你怎么可以忘记我	0
我在看综艺节目。我最近爱上了一个叫《快乐喜剧演员》的综艺节目。你看不出来吗？	我不看娱乐节目	0
我友人也这样说，那你平时就干什么呢？	吃饭，睡觉，打豆豆!	0
你知道我28岁是哪一年吗？	不知道，我只知道我是90年的	0
你知道哪个城市太大了吗？	不知道，你说说看!	0
我不太喜欢打篮球，你喜欢看影片吗？	喜欢啊,但是都没有好电影了	0
是的，你通常喜欢什么？	我喜欢安静，安静的看书!	0
你开什么类型的车？	我开福特福克斯，怎么了？	0
喔唷	我比你小,我才13	0
那你当年高考的时候轻松吗？	轻松，因为是文科生，所以还好。	0
你知道我特别喜欢哪个国家吗？	不知道，你喜欢哪国？	0
啊哦	挺好的!就是有点忙!	0
你来自哪个省？	我来自广东，你是广东哪儿的？	0
你知道我住在哪个县吗？	不知道,但我知道,15岁,不应该,在,这里玩	0
你平时讨厌听谁的歌呀？	都不喜欢，我只是喜欢听歌而已	1
他加班，所以没出去。你一个人去健身房了吗？	没有啊，我都是和朋友一起去的	0
你业余时间做什么？	看书、看电影、看书、听歌、看书	0
我多大了？	32啊	0
我是广州人士，你呢？	我是四川南充的哦,你是学什么专业的?	0
你好，我们可以交友吗？	当然，当然，我们是好朋友!	0
巴耶来自哪个城市？	巴爷是在北京买的	0
喔	你可以关注我微博,有什么问题都可以问我	0
哦？	那你喜欢什么样的生活？	0
学生在学校的最后一年是哪一年？	高中毕业吗,我也不知道诶,	0
你知道我附近有哪座山吗？	你不是说了吗?你家有座山	0
但是你游泳的时候不需要摘下眼镜吗？	不带泳镜,我怕看不清	0
你以前有工作经验吗？	有啊，不过不是这个专业的	0
那你呢？你吃过了吗？	刚吃过,准备上班啦	0
谁模仿得好？	不知道，我只看过他演的电影	0
是的，你没有什么喜欢做的吗？	我喜欢睡觉，睡觉是世界上最美好的事情	0
你不会弹吉他吗？	不会，你教我吗？	0
你不出去度假吗？	我是宅女，我不喜欢出去玩!	0
不知道怎么过活？	是的,没工作	0
似乎是这样。你是做什么的？	我是做汽车销售的。	0
谢谢你！你是什么劳作的呀？	我是开了一家小小的微店,卖衣服	0
好吧，那你是做什么劳作的啊？	我是做物流的，现在在一家汽车公司做销售。	0
那很好。你可以放松一下。你多大了，没有孩子？	孩子三岁了,我都上班好几年了	0
你知道我叫什么名字吗？	我知道你叫姜昕。	0
你多大了？	我是95年的,叫我哥哥就好	0
哇塞你好厉害啊，有什么惩罚吗？	你想要什么样的惩罚呢？	0
你好，你不想去上学吗？	我也是要去大学上学的呢	0
你知道谁是最受欢迎的歌手吗？	当然是阿信啦	0
…	我喜欢和你聊天，可以吗？	0
你拍了多少张照片？	不多,几十张	0
你有计划什么时候来吗？	我想12月初去	0
你闲空工夫都喜欢做什么啊？	我喜欢看书，听歌，看书!	0
那你经常回海边吗？	我喜欢在海边看日出日落!	0
你知道我最喜欢的摇滚乐队是什么吗？	是什么呢？	0
你很讨厌看漫画啊？	嗯,看不下去,没啥内容	0
咳咳咳	怎么了?你是不是也在上学呀	0
你在这份工作中做什么？	我是做室内设计的	0
你不和你父母一起去吗？	他们不一定去,可能不让我去了	0
你班的班名是什么？	你在哪个学校读?现在实习什么?	0
我多大了？	我不造,你没说,反正肯定比我小	0
咯	好吧,我也是护士	0
你现在住在哪里？	我住在罗湖,离罗湖地铁站很近	0
你学什么语言？	法语和意大利语，你呢？	0
噢噢	你身材也很好啊!	0
这么早就看小说，你不去上班或上学吗？	上班啊。但是我不喜欢看小说。	0
你没有狗吗？	有啊,我的狗狗在家里啊	0
很多人经常去你的录音室录歌吗？	没有,我这里不允许	0
你知道我经常听什么类型的音乐吗？	不知道，你说说看!	0
安息日你几点上班？	八点半到下午四点,中午午休一个小时	0
你所在的年级叫什么名字？	我不知道，我只知道我的名字!	0
这项工作是在哪里完成的？	北京呀,我是老师,所以有这个项目	0
太好了。你一个人吗？	是的,一个人自由行	0
你什么时候想吐？	下午的时候呀	0
你一定要上课吗？	不上不行,你不上?	0
你知道我星期几上学吗？	好吧,我比你小一点	0
喝啊	哇,这么有缘的嘛	0
你不是为了投资而买股票吗？	现在是在做股票投资啊	0
你知道我多大了吗？	不知道，你告诉我吧!	0
你有工作经验或专长吗？	没有，都是自学的	0
哦，你经常听德云社的相声吗？	嗯,是啊,不过现在听的少了,以前常听	0
好的，你有什么爱好吗？	我喜欢睡觉，不喜欢运动!	0
记者来自哪里？	北京，你呢？	0
我很喜欢打羽毛球，你有厌恶的球队吗？	有啊,很多啊,不喜欢林丹	0
。。	是啊，我都不知道该怎么办了	0
咯	你是卖这个的?还是要送我	0
你不出去度假吗？	不想出去，太热了!	0
你想在哪里学习？	东京,京都,大阪,京都大学	0
今天是星期几？	星期五。	0
你好，你现在不忙吗？	还好，不忙!	0
你知道什么时候写的吗？	我不知道诶,姐姐可以教我吗	0
是不是玩耍挺好的呀？	还行,不疯不闹,不吵不闹	0
你在咖啡馆工作吗？	没有,我也喜欢咖啡,你在哪家咖啡店?我以后有空去看看	0
嘿嘿对	你在成都读书吗?	0
你告诉他名字了吗？	告诉了,他知道	0
你来自哪个省？	我来自广东，你在哪个省呢？	0
是的，我在我家附近开了一家小工作室。你不去上班吗？	不想去了，太忙了!	0
你什么时候送走的？	大概半个月前吧，我都不知道它去哪了	0
哈咯啊	我是一个有问题的人	0
这是第一次，你能告诉我你现在在做什么吗？	我现在在一家广告公司做平面设计。	0
我最喜欢的乐队是什么？	我也不知道，只知道他们的歌很好听	0
哦，你们卖什么样的车？	我不卖车我朋友是卖车,他那都是好点的车	0
当然要我教你画花吗？	嗯嗯,要啊	0
每个人都有自己的生活。你为什么要告诉我该怎么过我的生活？	因为你是我的朋友，我想和你做朋友。	0
你在这座城市多久了？	我在这里有10年了吧!	0
你一定赚了很多钱，对吧？	没有,我只是在国企上班	0
可以啦	你也玩吗?哪个区啊	0
是哦	你有在海边住的房子吗?	0
你知道我喜欢的运动叫什么吗？	不知道。	0
你家有多少只仓鼠？	我家只有两只仓鼠	0
你知道我在哪里工作吗？	不知道,我在海淀,你呢	0
糟啊！你还在上学吗？	对啊，我还没毕业呢!	0
你什么时候是大一新生？	我今年刚大一	0
嗯呢	你在哪个大学啊?我是大一的	0
你知道我叫什么名字吗？	你也叫梁乙旭?	0
你不想当医生吗？	我不想，我只是想跟你聊天而已!	0
你知道我多大了吗？	我不知道你有多大,反正我是九六年的	0
那你厌恶的是什么？	我厌恶我喜欢他，他不喜欢我	0
那你现在是怎么过活的呀？	现在我在家带孩子,你呢	0
宿舍楼二楼是几号？	我是在五栋,你也是五栋的?	0
你非常喜欢听布鲁斯音乐吗？	嗯,布鲁斯,电子音乐,流行音乐,交响乐,等等,都比较喜欢	0
你知道我在哪家公司工作吗？	我知道你在麦当劳	0
你好，周末愉快。你有什么计划吗？	没有啊，我在家里宅着呢!	0
可是你结婚后不就阻断你发展的路径了吗？	我不想要婚姻，我只想要一个家。	0
你知道每个人到什么年龄还在学习吗？	不学习的人也会在学习	1
《工夫煮雨水》你听过吗？	听过,但不是很爱听	0
看来你们很相爱。你有孩子吗？	是的,你也快了吧?你和她现在还联系吗?	0
高中第一年是哪一年？	我是09年毕业的，你呢	0
你认识这个专业吗？	认识啊,这个专业有两个班	0
你什么时候上班？	我今天休息，明天上班!	0
你知道谁是我最喜欢的音乐家吗？	我知道，你最喜欢谁？	1
唉	我是河北的,在北京	0
咱俩差不多，都挺累的，能看看你拍的著作吗？	你在哪学的摄影啊	0
你在博物馆工作，喜欢读书，你有很多朋友？	没有啊，我都是一个人。	0
你知道我最喜欢吃什么样的快餐吗？	不知道,我不喜欢快餐	0
你闲空工夫都喜欢做什么啊？	我喜欢看书，看电影，打豆豆。	0
你多大了？	我90年的,孩子三岁了	0
你知道谁是反战歌手吗？	我也不知道,我觉得张杰唱歌挺有感觉的	0
你的国籍叫什么？	我的国籍？我不知道啊!	0
嗨，你好啊，今天劳作忙吗？	我没劳作,我是无业游民	0
我现在在乡下，因为我的家乡在乡下。我每天都呆在家里。这很无聊。你呢？	我天天在家看电视	0
是的，我认为狗很听话。你不喜欢吗？	喜欢,但是没地方养	0
负责调查的人叫什么名字？	我叫叶薇，你叫我小萌就可以了。	0
三年级的学生人数是多少？	我教的是一年级，我们班有20多个学生。	0
你什么时候休息？	今天休息,明天上班	0
真是巧合。你不是兽医吗？	我不是,我是做宠物美容的	0
你知道什么样的鸡肉很好吃吗？	不知道,反正肯德基的是鸡肉	1
不，我是中国人。你从哪里来的？	我从北京来的，现在在北京工作!	0
什么样的女孩很可爱？	你这个问题问的，我也不知道啊	0
你在哪里？	我在上海，他也在上海。	0
那你学音乐，不会也是因为家长吧？	不是啊,因为我是艺术类生,我爸妈不反对我的选择	0
你知道我在哪里学习吗？	不知道,你说了我不就知道了	0
对呢	你呢,喜欢干嘛?	0
紫禁城在哪里？	就在故宫边上啊，你不知道吗？	0
你是哪里人？	我是辽宁人,现在在山东	0
你知道补贴的最低年龄是多少岁吗？	我不知道，我只知道我要结婚了。	0
你知道我每天做几顿饭吗？	不知道，你做的好吃吗？	0
在网上工作要花多少钱？	不用啊,我加盟做的,现在都是这样做的	0
你好，你们认识吗？	不认识，我是路人甲乙丙丁	0
可以啊	可以什么呀可以,我都要愁死了	0
噢噢	那你就找个学霸男朋友,带你飞	0
对吧	你看的是哪个网的?	0
你知道另一个多大了吗？	你不会生了三个吧你	0
谁是我最喜欢的艺术家？	朋友我是山东烟台的,谢谢您	0
病毒传播花了多长时间？	这个我也不太清楚!	0
你好吗	我很好，谢谢你的关心!	0
你知道我从哪里来吗？	不知道啊，所以才问你啊!	0
可	那你可以教教我怎么开网店吗?留个电话把	0
是的，爱是美丽的。你没有恋爱，但是？	我没到谈婚论嫁的地步	0
是的，我经常跑步。你有最喜欢的运动吗？	没有诶,你呢	0
高中毕业后你为什么不去上学？没有理由吗？	不想上就不上了,哪有那么多为什么	0
你去过多少地方？	你说的是国内还是国外还是国内的旅游景点?	0
~~	那你还说你离婚了	0
唉唉唉	你在这里做什么？	0
你什么时候去上班？	明天上午去，你呢？	0
你好，你想生活在幻想中吗？	不想!	0
哇，你真棒。你的专业是什么？	室内装饰设计，室内装修设计，家具设计。	0
你好呀，我想和你交个友朋，好不好呀？	好呀,妹子,我喜欢	0
我来自哪个省？	不知道,我又不是算命先生	0
你什么时候开始工作？	我已经在上班了!	0
嗨嗨	嗨，你是哪个学校的？	0
我喜欢购物，经常出去吃饭。你喜欢购物吗？	我也是喜欢购物	0
你好，你能帮我照张相吗？	当然，你有什么要求吗？	0
我通常什么时候起床？	一般都是下午	0
是哦	有机会一定要去体验一下大海的魅力	0
什么时候很难睡好觉？	我在家睡得挺好,在学校睡得不好	0
你呢，你也是在放工吗？	我现在在放工	0
你不是每天都锻炼吗？	最近是	0
是的，我的肌肉非常发达。你想看吗？	当然，当然!	0
你为什么这么忙？	我也不知道啊,可能是带孩子累的	0
你是哪里人士啊？	我是湖北人，现在在北京工作!	0
你好你能帮我找到灵感吗？	你想要哪方面的灵感呢？	0
你好，聊天吗？	你好,你要聊啥	0
谁写了一本关于推理小说的书？	东野奎吾的《白夜行》	0
一天中什么时候天气好？	今天是阴天，明天是晴天，后天是大晴天!	0
你什么时候去上班？	明天上午去，下午就可以走了!	0
你知道我去哪里卖椰子吗？	不知道，我只知道你要去卖椰子	0
是的，我就是这个意思。你高中毕业了吗？	没有啊,中专毕业	0
你喜欢什么时节呀？	秋天，冬天都喜欢!	0
是的，除了注意健康，你没有什么爱好吗？	我也挺喜欢电影和音乐,我平时没事也会听音乐,但是很少注意别的	0
你知道我多大了吗？	我只知道你有个孩子	0
你在玩电子游戏。你不是很喜欢吗？	我不玩呀我是玩游戏的呀	1
你每天早上锻炼吗？	没有,一般下午或者晚上,有时候是下午	0
你在这个行业干了多少年了？	快5年了，你呢？	0
我住在中国的哪个地区？	你是哪个省的？	0
金色的头发和其他的线是用来做什么的？	当然是做衣服啦!	0
一个工人一个月能挣多少钱？	那就要看你在哪里上班了,一线城市工资高	0
当然你还在学校吗？	对啊，我在学校呢，你在哪个学校？	0
你知道我喜欢听谁的歌吗？	不知道,你说说?	0
你经历过这种情况吗？	没有，我只是想知道为什么会这样	0
是呀，你有讨厌的女孩子吗？	有,但不算很讨厌	0
你什么时候去的公司？	我现在在去公司的路上,你呢?	0
啊，那样的话，你可以告诉我，你通常喜欢做什么？	我喜欢看书，还喜欢看电影!	0
你工作不忙吗？	我是在一家公司的财务部工作,工作不太忙	0
真的吗，你最不喜欢的画是什么？	不喜欢画人	0
你知道我什么时候请假的吗？	不知道，我也不知道。	0
你知道我最喜欢的乐队是什么吗？	不知道!	0
当然你现在在做什么？	我在上班啊，我在银行上班啊!	0
24岁似乎是婚姻的分水岭。嘿，你结婚了吗？	孩子快两岁啦	0
我妈妈是个蓝领，做事雷厉风行的，你妈妈呢？	我妈做事也雷厉风行	0
你知道我妻子和我谈恋爱花了多少年时间吗？	我不知道，我只知道她是个医生。	0
你在哪里上学？	北京啊，你呢？	0
对唉	我在用手机看呢,电视太小,看的不舒服	0
你在哪？	我在钦州市啊，你呢？	0
你所在的国家叫什么名字？	我现在在泰国	0
你知道我多大了吗？	不知道，我只知道你的年龄	1
咳咳咳	我都不知道该怎么跟你说了	0
你是北京人吗？	不是，我在北京待了四年了。	0
哇，太棒了。我也喜欢。我们找个时间出去吧。你开车，我带我的狗，好吗？	我不太会开车	0
没关系。看一看，练习一下你的勇气。今天不是周末。你今天打算做什么？	我要去上课啊	0
哦，你喜欢独自攀岩吗？	不喜欢，我喜欢独处。	1
我多大了？	你应该比我大吧!	0
你多大了？	我今年21岁了，你呢？	0
你在哪里？	我在北京啊，你在哪呢？	0
我点了外卖。你点了什么？	我点了麻辣香锅!	0
谁拍的这部电影？	不认识,在网上看到的	0
你最喜欢的运动是什么？	羽毛球、网球、乒乓球、羽毛球。	0
你是干什么劳作呢？	我是做景观设计的，你呢？	0
你痊愈了吗？	痊愈了，还活蹦乱跳的	0
你通常工作很长时间吗？	是的，基本上都是一个小时左右。	1
哇哇哇	你也是做这个的吗？	0
你经商多少年了？	三年吧,你了	0
你知道我最喜欢的乐队是什么吗？	不知道!	0
你好，你是哪儿人氏？	你好,可以问你是江苏哪儿的人吗?	0
你什么时候做了一件重要的事？	今天是我的生日，我想送给你一件礼物!	0
谁是你的男神？	你是我的男神，我是你的女神!	0
你知道数学老师在几年级吗？	不知道诶,不过我是高三的	0
对呢	我不认识你,你是谁	0
你喜欢哪个国家？	中国吧,中国文化博大精深,而且我也喜欢中国的文化	0
你真的太客气了，你的衣服上面有狗，你很厌恶狗吗？	不讨厌,也不喜欢	0
你家有多少只猫？	一只，两只，还有一只大的!	1
哇，寸土寸金的地段，你一定很有钱吧？	是啊,所以你要来跟我做朋友么	0
那你很厌烦警片吗？	还好，我比较喜欢看恐怖片!	0
可以啊，我是一名学员，你是干什么的呢？	什么学员啊	0
你知道我喜欢什么样的食物吗？	不知道,但我知道这不是上海菜	0
你和家人住在一起吗？	嗯,跟父母住一起呢	0
对啊	你是哪里人?我是河北人	0
唉	你也要去这个学校吗?	0
你喜欢哪个国家？	我喜欢的国家太多了，你说哪个？	0
你知道我最喜欢的节日是什么吗？	中秋节?	0
还剩多少年？	还有三年，明年就毕业了!	0
你读了多少本书？	看得比较少,才几本而已	0
哦，你还没吃东西吗？	在家里啊,我在等着吃晚饭呢	0
你独特的爱好是什么？	我喜欢听音乐，喜欢听歌，喜欢看书!	0
……	你是做平面设计的吗？	0
你经常做志愿者吗？	不经常,就去了一年多,以后也不去做了	0
你知道音乐家的名字是什么吗？	我知道他是音乐家,但不知道名字	0
你不打算自己学习吗？	我也想啊，可是我不知道去哪里学	0
是的，你喜欢看综艺节目吗？	是呀,综艺节目是我最喜欢的了	0
在	你喜欢什么类型的电影？	0
我什么时候才是成年人？	你不是已经成年了吗？	0
你什么时候去？	明天吧，我还没买票呢!	0
噢噢	男生怎么了嘛	0
你知道我每天跑多少米吗？	不知道,反正是我我会坚持不了,你是女的,体力肯定比我好	0
你有没有养小植物？	有啊，不过都被我养死了!	0
你一个月挣多少钱？	那你做的不错啊,怎么做的啊?	0
演出将持续几天？	这个就不知道了!	0
你知道我几岁结婚的吗？	不知道。	0
看你的头像可能是女孩子吧？	那我就是女的吧	0
你花了多长时间才认识月季和山茶花？	月季一个月,茶花三个月	0
你好，我是青岛的人选，你呢？	我现在就在青岛呢	0
你知道我害怕多少事情吗？	我知道，你害怕的事情太多了!	0
你叫什么名字？	我叫小静，小雅是我的名字。	1
你知道我订婚多少年了吗？	不知道，我只知道你结婚了	0
你通常什么时候工作？	晚上八点到早上七点	0
你住在哪里？	望京东	0
我是哪里人？	中国,你是中国人	0
你知道谁是最好的吗？	不知道，我只知道我喜欢的人是谁!	0
听起来不错，但你不觉得很麻烦吗？	有什么麻烦的，我又不是小孩子。	0
看来我们有共同语言了，你喜欢听什么类型的歌曲啊？	我比较喜欢英文歌	0
呃呃	你的小窝是公主床?	0
是的，你现在的工作是什么？	我做的是财务	0
你知道docosa的西班牙语单词是什么吗？	不知道,我不是西班牙语专业的	0
是啊，你做事时候讨厌做什么啊？	没有什么讨厌的啊	0
你妈妈真的很好。你在这里干什么？	我在这里上班啊!	0
你从没去过哪个国家？	意大利，荷兰，比利时，法国，瑞士，瑞士。	0
最小的女儿什么时候出生？	去年11月生的	0
诶呦	我是个苦命的人,天天加班	0
你不是经常在公园里散步吗？	是啊，可是我不喜欢。	0
你不是经常在公园里散步吗？	是啊，可是我不常来啊!	1
你知道他们什么时候带我出去散步吗？	不知道，我也不知道。	0
我喜欢听李宗盛写的歌。你不认识李宗胜吗？	不认识啊、他干嘛的啊?	0
你好，我是一名销售员，我在一家公司的销售部劳作，你呢？	我在一名小公司的研发部，你在哪里？	0
你好，你多大了？	我也是93的，你是哪年的？	0
我正在吃早餐。你吃了吗？	我都要准备吃午饭了	0
你一定住在海边，是吗？	是的，这是我的房子	0
你平时除了歌唱没有其他的爱好吗？	没有,平时就只唱唱歌	0
你知道我最喜欢谁的音乐吗？	你喜欢谁我都喜欢看你的	0
就叫我小明吧。你叫什么名字？	我叫小蓝，你叫小黄吧!	0
你喜欢什么季节？	夏天!冬天!都喜欢!	0
你吃了多少面包？	两个啊,你以为?	0
你多大了？	那也还年轻啊,不着急,你还年轻	0
你知道主人公手里拿着什么动物吗？	我也不知道啊,你说	0
你一定很年轻吧？	嗯,还很年轻,我都24了	0
我受宠若惊。我受宠若惊。你周末不工作吗？	我是做销售的,周末都要上班啦	0
你知道和我住在一起的人的年龄是多少吗？	不知道啊!	0
是吗，那你最厌恶画什么了？	没有最厌恶的,只有最喜欢	0
呗	你是哪个学校的？	0
我去过哪个城市？	北京，北京，重要的事情说三遍!	0
没有，我在家照顾孩子，没法出去上班，你放工了呀？	没有,还没放呢,你在家好好照顾孩子吧,我过几天也出去上班了	1
员工们每天几点上班？	八点上班,七点左右就要起床	0
我受宠若惊。我受宠若惊。你周末不工作吗？	周末当然要上班啊	0
你在做什么？	我在跟人聊天呀，你在干嘛？	0
你属于哪个俱乐部？	我是学生会的，不过我已经退出了。	0
你住的城市叫什么名字？	我是河北邯郸的,我在北京工作呀,你在哪个城市?	0
是的，你也不开心吗？	是啊,我很烦恼的	0
和你在一起的人的年龄是多少？	25岁，我不知道。	1
我喜欢购物，经常出去吃饭。你喜欢购物吗？	还好吧,但我喜欢吃	0
你所在的高年级叫什么名字？	我是准大二的,比你高两届哦,	0
上帝，你的家人不能允许你表演吗？	当然允许呀,我的家人是不会强迫我去做什么事的	0
你在哪里上学的？	我在北京上学，现在在北京工作。	0
太远了。你一个人吗？你要坐飞机去吗？	对啊，一个人啊!	0
也许吧。你工作累了吗？	还好，只是偶尔会有点累!	0
嗨，今天这里是蓝色的。那里的天气怎么样？	今天的天气很晴朗，阳光灿烂!	0
嗨喽	你呢,吃饭没?	0
好吧，我回来后再看。你是做什么的？	设计啊,做建筑的,你呢?	0
那你平时讨厌看电视吗？	也不讨厌啊,看电影多点吧,电视剧也看啊	0
你通常什么时候有空？	我通常都是早上八点到八点半这段时间。	0
你知道你多大了吗？	我的意思是你还可以活个几十年!你想什么呢	0
全副武装，你要去哪里？	我要去你家,你家没人的时候	0
你知道美国队长来自哪个国家吗？	美国队长是谁?	0
你好，你今天休息吗？	我今天去上班了	0
你看过中国四大名著吗？	没有，好看吗？	0
喔唷	是不是觉得我很机智	0
你有什么好的建议吗？	我也不知道，我也想知道!	0
嘛	你说的我都喜欢呢,不过我更喜欢做自己喜欢的事,不太喜欢逛街	0
好呀	学妹，你是哪个学校的？	0
你知道我丈夫什么时候死的吗？	不知道。	0
你在哪里能买到房子？	上海啊，我是说我买不起上海房子	1
那确实是挺让人选烦心的，你不知道是什么缘故吗？	不知道,可能是家里的原因,但是我真的很想他	0
你不喜欢姜文的电影吗？	不喜欢，我喜欢看他的书	0
今天周末我忍不住又去购物了，我喜欢购物，你讨厌吗？	我不讨厌,我讨厌逛街	0
油画是我艺术史上最喜欢的课程。你通常不喜欢做什么？	不喜欢画画，也不喜欢听音乐	0
哇呜	你也不回么?	0
嗯呢	你是哪里人？	0
你假期喜欢做什么？	我喜欢睡觉，不喜欢宅着	0
喔	那你现在的工作是什么?	0
是呢	那你来找我吧!	0
你没有什么爱好吗？	看书算吗?	0
别担心，父母这样做是为了你好，不怕你受骗吗？	我不担心，因为我知道他们不会骗我!	0
噗	我也没有不开心,就是有点无聊	0
你有多可爱？	我不可爱,我是帅	0
你是做什么的？	我是做互联网行业的，你在哪个城市？	0
高三的人数是多少？	你是指哪一届?	0
你教的是什么专业？	我教的是通信工程，你呢	0
你是哪里人？	我也是河南人,河南驻马店,你呢?	0
这么棒呀，那你有没有参加有关这些棋类竞赛呢？	没有啊，我是菜鸟	0
他上次见到她有几个月了？	三个多月了，还有一个月就生了!	0
你打算怎么办？	没办法啊,就这样呗	0
刚刚结束。你吃了吗？	刚吃完，你吃的什么？	0
真好，大学过活是很精彩的，你一定交了很多友人吧？	不多，只有一两个。	0
你买了多少套房？	两套啊，一套房，两辆车!	1
你知道每年7月我都去哪个城市吗？	不知道啊，你要去哪儿？	0
嗨喽呀	好吧,你是个爱学习的好孩子	0
你家里有多少只猫？	两只，还有一只是公的，一只是母的	1
你多大了？	比你小几岁啊	0
我要吃多久土豆？	你想吃多久就多久!	0
是的，你想跟我谈什么？	我想跟你谈谈人生理想	0
你上过多少次厕所？	你这是想问什么呢?	0
你们要去哪里？	我们想去欧洲，我想在那里生活。	0
没事的，你现在是已经劳作了还是在上学呢？	我还在上学，呵呵!	0
喜欢是最重要的。你结婚了吗？	没有，只是不想结婚而已	0
你知道我喜欢在白天什么时候吃饭吗？	不知道,你说吧,	0
北京的城市在哪里？	不知道!我没去过	0
你知道我开始拍电影的时候多大了吗？	我不知道，你告诉我吧!	0
那你一定是个女孩？	你这什么表情,难道是男的么	0
上帝，你的家人不能允许你表演吗？	我不是上帝,我是神,神不允许,我允许	1
哎哎哎	那有没有特别喜欢什么东西呢?	0
我们成了朋友。我们谈谈吧。你的爱好是什么？	我喜欢旅游，喜欢摄影，喜欢看电影	0
你有几个孩子？	两个，还有一个儿子。	0
我一般都是坐公交车，每天忙碌忙碌的，大部分时光都用在出行上了，你做什么劳作的，平时忙吗？	平时上班,不是很忙,打理下我的小店,每个月差不多3千多点吧	0
你喜欢什么季节？	秋天，冬天都喜欢	0
哦，那您这可真够厉害的，那你这也算是个冒险家呀，那你平时还厌烦做什么呢？	我不知道，我也不知道。	0
你的薪水怎么样？	还行吧。	0
那人有多少瓶？	没数过,他不喝,我喝的	0
我们别谈这个。你最近在做什么？	我最近在找工作啊!	0
你最喜欢去哪一个地方？	云南，西藏，西藏是我一直想去的地方	0
你想考哪所大学？	我要去北大	0
你知道我一周读多少本书吗？	不知道。	0
哇，这些动物很可爱，不是吗？但你住在哪里？	我住在广州白云区啊	0
你知道我有几条狗吗？	难道是三条?	0
你知道我特别喜欢谁吗？	不知道，你告诉我吧!	0
你知道我最喜欢哪部电影吗？	不知道!	0
你以前学过什么专业？	学的幼师	0
有多少人？	20了,有10来个了	1
那你厌恶吃东西吗？	不厌恶啊	0
你最喜欢谁？	我喜欢的人多了去了!	0
你家是动物园吗？	不是，我家只是个动物园而已!	1
是吧，对了你平时讨厌看恐怖小说吗？	看啊,但是不看恐怖的	1
你想在哪里学习？	我想在日本	0
你所在的班级叫什么名字？	你在学校是什么职务?	0
好哦	有什么好哦	0
你有多胖？	不告诉你,反正我知道你很瘦	0
你应该年轻，不是吗？	我是说我老了，不是说我还年轻!	0
你知道我做3D建模师有多少年了吗？	我知道!我也是3d建模师!	0
你知道我有几个女儿吗？	不知道，我只知道你有一个女儿。	0
广告公司，你的收入如何？	我的收入很低，都是别人给我介绍的	0
是的，我住在北京。为什么，你也是？	我在海淀，你呢？	0
那你的劳作是老师吗？	劳作是什么?	0
那你应该快跑？	那我就跑的快一点	0
你业余时间做什么？	画画，看书，旅行，看书	0
嗨喽	好巧,我也喜欢看书听音乐看电影	0
唔	你呢,工作了吗	0
为什么要和老板一起吃饭？	因为我是他朋友的朋友的朋友的朋友的朋友	0
你说得对。你不工作吗？	我在上班呢,你也是今年毕业的?	0
还没有。我下个月要拿到驾照。你做完了吗？	做完了啊!你是哪个驾校的？	0
你知道谁是我最喜欢的音乐家吗？	我不知道，你知道吗？	0
可以哦	欢迎光临，有什么想知道的都可以问我	0
……	你也要考?考哪的?	0
对哦	我也是,不知道干什么,你是哪里的呢?	0
我喜欢哪个朝代？	你喜欢哪一个朝代呢？	0
你知道我多大了吗？	不知道啊，你多大啊？	0
嘘	好吧,我要听你瞒我瞒	0
你在哪？	我在广东中山,我都没去过北方	0
那你有没有找到劳作呢？	没有，我还在找工作，你找到了吗？	0
你知道谁是我最喜欢的主持人吗？	张卫健?	0
嗯嗯嗯	哈哈哈,你是不是在想我有多无聊呀	0
我也是。你是在工作还是去上学？	上班了，还没找到合适的工作!	1
你是大学生吗？	是啊!你呢？	0
你不会弹吉他吗？	不会，我只会弹一闪一闪亮晶晶	1
我现在在一家建筑公司工作。你呢？	你在哪里啊,我们距离只有一百米	0
你最不喜欢哪个队？	不喜欢拜仁	0
你妈妈在哪里工作？	我妈妈在做生意	0
你知道糖醋鱼来自哪个国家吗？	不知道，你知道吗？	0
她有多少只猫？	一只啊，一只公的，一只母的!	1
的确是大的太多了，那你是做什么劳作的？	我是做服务业的，呵呵!	0
哪个大一新生从生活中汲取更多？	这个问题我不好回答哦,不过你要知道,大学是一场说走就走的旅行	0
你喜欢她吗？	我也不知道,我感觉我不喜欢他了	1
你能演奏什么乐器？	我会的乐器可多了，比如钢琴、吉他、吉他	0
哇，太棒了。作为一名举重运动员，你应该有很大的力量，对吗？	是的，我有很大力量!	0
你知道我喜欢什么时候做三明治和一杯豆浆吗？	不知道,难道你要告诉我吗	0
哦哦嗯	你很好,你很幸福,我很羡慕	0
我刚结婚，准备去度蜜月。我现在在深圳。你知道深圳附近该去哪里吗？	深圳有很多地方可以去啊!	0
你什么时候毕业的？	今年六月份毕业的。	0
喂	你要吃我做的饭？	0
你什么时候进来的？	刚进来没多久，我是在豆瓣上看到你的。	0
你什么时候要工作？	明天就要去上班了!	0
你喜欢的人是谁？	斯内普是我最喜欢的一个角色!	0
嗨	本地的怎么了,有什么问题吗	0
哪个季节太热？	这个问题问的好,我竟然无言以对了	0
你也是乐队成员？	我是鼓手	0
火车什么时候到？	下午四点多的火车，估计五点多到学校吧	0
哦	你是在成都上学吗	0
所以你还是工作到这么晚。这会影响你第二天的学习吗？	不会，因为第二天要上班!	0
你教的是啥专业啊？	我在教小学,英语	0
你每天工作多少小时？	不固定啊,有活就干,没活就呆着	0
看过不太喜欢，我喜欢看喜剧类型的，你讨厌看什么类型的？	喜剧类的都不喜欢，不知道为什么	0
你对其他事情满意吗？	很满意呀	0
你知道我叫什么名字吗？	你是谁啊?你是佩奇吗?	0
我认为是这样。你在工作吗？	是呀,工作了	0
你在哪里工作？	我也在北京呢	0
除了画画你还有工作吗？	有啊，你要来吗？	0
嘤嘤嘤	我也是餐饮行业的，你在哪个城市？	0
什么时候休息？	一个月休息几天	0
别累了。不要总是谈论我。你是做什么的？	我是做it的，你在哪个城市？	0
你知道我一周在剧院演出几次吗？	不知道，我只知道你很厉害!	0
你多大了？	我是91年的。你呢？	0
你在哪里学习？	我在山东济南,你呢	0
不，我只是对我的家庭不满意。你是做什么的？	我是做建筑设计的，你呢？	0
你知道我多大了吗？	不知道，我只知道你是程序员!	0
你知道我做了什么吗？	不知道!	0
你住在哪里？	我住通州北苑，你呢	0
你多大了？	我都20好几了	0
你在哪个城市？	我在天津，你在北京哪个地方？	0
你多大了？	我不知道，我只知道我快奔三了!	1
我的班级是几年级？	三年级，你呢？	0
你什么时候睡觉？	12点多就睡了	0
你从没去过哪个国家？	我没出过国门,哈哈	0
我也是。你是在工作还是去上学？	我在上学，不过马上就要毕业了。	0
啊哦	我还好，你呢？	0
你打什么联赛？	我只是黄金的渣渣	0
我之前也试着种过花，可是最后都没活下来，你是有什么门路吗？	我还没试过种花呢!	0
我的家在河南。你从哪里来的？	我是河南的，现在在北京!	0
好的，你现在是在上学还是已经劳作了？	我在上学，我现在是上班族。	1
如果我说有一天我会成为一名大设计师，你会相信我吗？	相信，为什么不相信呢？	0
那你为什么不把它绑起来？你不能把它分开吗？	他说我不听话,然后就把我绑了	0
你是谁？	我们好像不认识啊,为什么要问我是谁	0
你来自哪个省？	我来自广东的一个小县城!	0
我在医院当档案管理员。你平时忙吗？	忙啊，不过我很闲的。	1
你知道我什么时候喜欢学摩托车吗？	我不知道啊,难道是你小时候?	0
你有几条狗？	我就一条	0
我想问，你在网上看漫画吗？	是的，我是漫画迷!	0
哼	哼啥?	0
你知道主人公手里拿着什么动物吗？	不知道!	0
你知道我跑几次马拉松吗？	我不知道啊,我只是觉得你很厉害,所以想了解一下而已	0
我受宠若惊。我受宠若惊。你周末不工作吗？	周末上班,我现在已经在上班了	0
那是大四的。我今年才大二。你学的是什么专业？	哈哈,我是建环的,大四狗咯	0
你知道我最喜欢的球队是什么吗？	我只知道你喜欢勇士	0
你知道我有几个孩子吗？	两个,一男一女	0
所以你还是工作到这么晚。这会影响你第二天的学习吗？	不会，我会继续工作的!	0
噗	战狼好看吗？我还没看过呢!	0
这是必要的。顺便问一下，你是做什么的？	上班族了,还有一间淘宝店铺	0
哇，你还是喜欢看今天的演讲。你不是律师吗？	我不是律师啊,你是不是回错人了	0
你好啊，还没呢，你怎么也有做事啊？	我也不知道，就是睡不着了!	0
你妈妈是做什么劳作的？	做生意啊,现在在北京	0
我13岁是什么时候？	你13岁的时候我还没出生呢!	0
你喜欢听谁的歌？	周杰伦!	0
那很好。你工作不累吗？	我工作累不累跟你有关系吗	0
你知道我来自的城市叫什么名字吗？	不知道,你来自哪里啊?	0
你为什么这么说？你也学医吗？	我学的是中医专业，现在在中医院上班。	0
我来自武汉。你不去上班吗？	没找到工作,怎么上班	0
你不喜欢吗？	不是不喜欢,只是不喜欢做	1
那业主去饭局一定会带着你吧？	不一定啊，我又不是老板，我怎么知道。	0
是挺远的，你是学员还是已经结业上班了？	学员，还没毕业呢!	0
被你的父母亲照顾的感觉不好吗？	你是想照顾还是被照顾?	0
负责调查的人叫什么名字？	我叫李晨，你是哪个部门的？	0
你在哪类公司工作？	我在国内一家上市公司做审计，你在哪里？	0
学生在学校的最后一年是哪一年？	我今年24岁,我在上大二	0
你知道我上的是什么样的大学吗？	不知道，你是哪个学校的？	0
位于马绍尔群岛的岛屿叫什么名字？	你说的这个我没听过	0
在	不,你不是那个盖世英雄	0
你什么时候是大一新生？	今年九月份开学	0
这也很正常，喜欢戏法的确实比较少，那你今天过得怎么样呢？	还可以啦,吃得饱睡得香	0
嗯对	那你有没有什么想说的呢？	0
你有几个孩子？	两个，一个男孩，一个女孩。	0
你为什么不想想？	我想了啊!可是我想不出来啊!	0
你知道谁是我最喜欢的艺术家吗？	我只知道有一个叫李娜的艺术家,很有实力	0
你知道我每天什么时候工作吗？	早上7点半,晚上10点左右	0
哼	咋了,你不喜欢?	0
你好，最近怎么样？	挺好的，就是有点忙!	0
能和你交个友人吗？	可以啊,那你想怎么交啊?	0
真的，我也喜欢猫。你养的是哪种猫？	英短啊	0
你要考哪所学校？	不知道啊，还没定下来呢	0
哦	你是哪个学校的？	0
哦这样啊，那个我喜欢烹饪，你讨厌干什么啊？	我讨厌做菜，我讨厌做饭!	0
你知道我什么时候上大学吗？	不知道。	0
呸	那你平时是怎么打发时间呢?	0
你放工很早吗？	不早啊，一般都是8点到9点半	0
啊，你不需要照顾孩子吗？	有妈妈	0
教堂位于城市的哪个区域？	在东区南区北区都有教堂。	0
“狗蛋”是什么品种的狗？	中华田园犬!	0
你知道谁的歌很好吗？	许嵩,徐良,汪苏泷	0
你来自哪个省？	好吧,我在河南,你在上海读书	0
你知道一个热情的人通常被称为什么吗？	热狗?	0
嗯，我明白了。别提我。你通常不喜欢做什么？	不喜欢的事情多了去了!	0
你几岁搬砖的？	搬砖也有年龄限制?我还真不知道	0
你是哪里人？	我是江苏的，现在在上海工作。	0
你的酒吧在哪？	我的酒吧就在这里。	0
是的，你呢？你多大了？你的梦想是什么？	我今年26岁了，梦想是能有一个自己的房子，有自己的车子，有一个属于自己的家!	0
看你的气质不错，一看就不是一般人，咱能接个朋友吗？	可以啊，只要你不嫌弃!	0
你讨厌看橄榄球吗？	我讨厌橄榄球,不讨厌篮球	0
那你现在在干什么？	我现在在上班，每天都是这样的生活	0
你一定住在海边，是吗？	是的，当然，我住在那里	0
谢谢你！你是什么劳作的呀？	我是做设计的,我也有很多爱好,我喜欢做手工制品	0
有多少年了？	不知道,我从网上买的,买的时候才一年的小龟,养到现在有两年了	0
袭击是什么时候发生的？	我也不记得了,好像是前几天吧,你有空看看你的日历,今天周末了	0
多幸福啊！你结婚十年了吗？	是啊，快十年了。	0
你上的年级是多少？	我也不知道，我只知道我是五年级。	1
一个月挣多少钱？	不固定啊,多的时候三四千,少的时候一千左右	0
你知道我是什么时候遇到那个合适的人的吗？	不知道，我也想知道。	0
负责调查的人叫什么名字？	我叫张晨晨，你叫我悦然就好了。	0
你通常喜欢做什么？	喜欢打什么游戏?	0
我在看探险剧目，你是做什么劳作的？	我是一个摄影爱好者，喜欢摄影。	0
你知道我在哪里毕业的吗？	不知道。	0
你知道负责这个项目的人叫什么名字吗？	不知道，我只知道他们的名字	1
我很喜欢周末去看电影，你厌烦看什么综艺？	跑男不喜欢,其他的看情况	0
看来我们有共同语言了，你喜欢听什么类型的歌曲啊？	我什么类型都听的,只要好听	0
这个家庭有几个孩子？	2个，还有一个弟弟。	1
那你工作不忙的时候厌恶做什么？	不知道，我也很想知道。	0
哟	你的头像真是让人浮想联翩啊	0
你最喜欢的地方是什么？	西藏，西藏，我喜欢那里的蓝天白云	0
我从事海报劳作，你呢？	我是做平面设计的，你在哪个城市？	0
那你现在在干什么？	上班，下班，吃饭，睡觉，打豆豆	0
你最喜欢的乐队是什么？	五月天，五月天。	0
你还会拆散电脑呢？	当然啦，我可是专业的!	0
我也喜欢唱歌啊，你厌烦谁的歌呢？	我讨厌的歌手多了去了，你问的是哪一个？	0
喝啊	是啊,你有什么好的方子没有?可以告诉我吗?	0
你通常什么时候去？	晚上啊，最近都是下午去的	0
我没听说过这个角色。你能给我简单介绍一下吗？	我也不知道她叫什么名字	0
你知道我有几个兄弟吗？	不知道,几个啊	0
那你一般卖什么比较多呢？	衣服,吃的,化妆品	0
一年中最喜庆的日子是什么？	春节当然是和家人在一起的日子啊!	0
啦	你是怎么学会的啊?	0
好啊，那以后在学校里面还要多找你帮忙呢，学长你平时厌烦干什么呀？	我不厌烦，只是不喜欢和陌生人说话	0
但是你害怕吗？	我不害怕，我只是.	0
你很喜欢山东菜。你是山东人吗？	我在济南上学的,我是江苏人,我觉得南京菜也不错啊	0
你通常喜欢做什么？	看书、看电影、看书、电影、电影	0
那你一定很喜欢运动吧？	嗯，是的!	0
你目前的情况如何？	还不错,有点钱,能养活自己	0
你什么时候出去？	晚上8点到9点	0
呀，好巧，我也有一只狗，我会在下班后买个压缩饼干给我的狗狗，你的狗狗平常吃什么啊？	我家狗是肉食动物，喜欢吃肉。	0
噢	你呢?最近咋样?	0
喔唷	你也有这样的想法吗	0
你知道我是哪里人吗？	看你说的我以为你合肥的呢	0
诶呦	哎呦是什么意思?	0
你都写过什么小说书？	我没有写过小说，只是写过一些小说!	1
网店一个月赚多少钱？	好吧,其实我也是没事,想找点事干	0
我们一起下棋，我挺喜欢玩棋盘戏的，你喜欢下棋吗？	喜欢,我喜欢下五子棋	0
好呀	你在哪个城市？	0
那你讨厌读什么类型的书呢？	不喜欢读小说，也不喜欢小说里的人物。	0
我也听说它是纯的。你没有工作吗？	有啊，不过还没找到。	1
93年你多大了？	我今年刚满十八岁。	0
你在上大学吗？	对啊，我在大学，你呢？	0
与肖有联系的人叫什么名字？	我是霏霏	0
你什么时候不做饭？	不想做的时候	0
那很好。你工作不累吗？	还好,没啥事,就是时间有点长	0
你知道我最喜欢的乐队是什么吗？	不知道,我只知道披头士的歌很好听	0
紫色会不会太炸眼呀，你爹妈愿意你染头发吗？	我爸妈还不知道我染头发,所以应该不会同意	0
我能说多少种语言？	你想要多少种？	0
呗	你做过收银?	0
你知道有多少母亲抚养我长大吗？	我也有两个,还有一个是我姑姑	0
嘻哈	哈哈,你也喜欢嘻哈	0
你喜欢网上购物吗？	不太喜欢,网购也不太靠谱吧,我觉得	0
你通常什么时候下班？	我一般都是六点半下班。	0
你知道士兵在哪个军种服役吗？	不知道,我只知道在哪个军区服役	0
你知道我家有多少动物吗？	不知道，你能告诉我吗？	0
你是不是很讨厌旅游啊？	你喜欢去哪里旅行啊?	0
生活费需要多少钱？	三四千就可以了	0
嘻	你喜欢什么样的画？	0
非常感谢。你通常喜欢做什么？	我喜欢看书，玩游戏。	0
你知道黑豹的吉祥物是什么动物吗？	不知道啊,是啥	0
是的，我能为你做些什么？	你叫什么名字？	0
好啊，我等着你找到不苦的咖啡茶，对了，你平时没事的时候喜欢做什么啊？	我喜欢发呆，喜欢一个人呆着。	0
你好，你忙吗？你有时间聊天吗？	有,你在哪呢,我去找你	0
嘿，嘿，我想问一下，你通常不喜欢做什么？	不喜欢上班	0
你工作时经常在哪里吃饭？	自己做饭,或者出去吃	0
哇，我真佩服你。你通常喜欢做什么？	我喜欢睡觉，打豆豆。	0
你知道我家养什么狗吗？	不知道你养的什么狗,你不是说你家有只二哈吗	1
嗬	你想干什么？	0
下次约会是什么时候？	这个就不知道了，看心情吧!	0
对对	你有没有用过呀?	0
你星期几去网球场？	这学期还没去过,上学期是星期三和星期四	0
咳	咳什么?	0
你想去哪里？	我也不知道,迷茫	0
你要去哪个城市？	我现在就在北京，明天就回去了!	0
什么时候出《什么来了》呢？	不知道，应该快了吧	0
可以哦	我是95年的呢,你比我大呢	0
你好，你有什么爱好？	我也一样啊,我也听歌看电影打游戏	0
你叫谁？	我叫科比	0
我买了多少本书？	你不是买了三本吗?	0
他从军多少年了？	今年第四年,还有三年	0
你什么时候毕业的？	我去年毕业的,你现在在哪里工作?	0
是	你是哪个学校的？	0
我的学校在大兴。你已经工作了吗？	没呢,我在上大五	0
呜呜呜	哎,没办法啊,你现在干啥呢?	0
可	那我该做什么?	0
嘿嘿对	你是学什么专业的？	0
你现在在哪里？	你在那边是做什么的	0
是	哈哈,那咱们有缘,我是洛阳栾川的,你呢?	0
那你们卡车司机是不是都会推着货到各种地方？	我不是卡车的,但是我是做工程的,有问题可以问我	0
看起来你追求很高雅嘛，那你有什么名人是最讨厌的吗？	讨厌没有,但是有讨厌的人	1
是的，你的家人呢？	好远啊,我是河南信阳的	0
秘书是什么？	就是专门背锅的	0
你是什么人？	我是一个有故事的人!	0
不可能。我经常熬夜。你是做什么的？	我是做软件的，你在哪个城市？	0
第一年的学习时间是多长？	不固定,三个月左右	1
你好吗我在银行工作。你工作过吗？	我在医院工作,没工作过	1
你在这座城市多久了？	我在这里快十年了。	0
是呢	你是男的还是女的？	0
...	我是你的朋友，你有什么事吗？	0
如果你继续这样下去，你会变成一个没用的人。你一个人吗？你的家人关心你吗？	我会变成有用的人，因为我还有家人	0
你还有其他爱好吗？	我的爱好就是爱好女	0
对啊，我超喜欢吃玉米粒，你喜欢吗？	玉米粒?	0
你借书的班级叫什么名字？	忘了,只记得是大二的	0
你每天工作多少小时？	早上八点半到晚上十点,中途休息两小时	0
是吧，对了你平时讨厌看恐怖小说吗？	以前看过,但现在不看了,觉得有点无聊	0
你是哪里人？	湖南人，你呢？	0
你班的班名是什么？	我现在在一家公司实习	0
嗯，是的，珍惜它。你通常喜欢做什么？	那你的小店是做什么的啊,我可以做吗?	0
你收集了很多纪念邮票吗？	没有,就几张	0
你通常喜欢读什么书？	历史类,经济类,文学类,历史地理类,小说类我都喜欢	0
爵士舞在你的生活中已经有多少年了？	5年了，断断续续的，你呢？	0
好的，你没有兔子吗？	没有,现在有一只仓鼠	0
你知道我多大了吗？	10岁啊	0
？	就是你说的喜欢的东西太多而最喜欢的却很少	0
你讨厌听谁的歌？	我谁的都喜欢听	0
你知道罗纳尔多是谁吗？	不知道	0
啦啦啦	种什么菜?	0
你明天什么时候走？	下午4点的飞机。	0
你知道你最喜欢的车是什么吗？	我不知道，你知道吗？	0
我更喜欢安静的音乐。你不喜欢吗？	也很喜欢的	0
你知道docosa的西班牙语单词是什么吗？	不知道,你学西语的?	0
你是不是年龄小了？	不小了，都快奔三的人了	0
在互联网公司工作的人的年龄是多少？	不知道啊。我也不知道。	0
和你在同一栋楼演奏的乐队叫什么名字？	是我一个朋友弹的,没记住名字,我是个业余的	1
你周围没有观众在唱歌吗？	没有,都是看的	0
你知道我在哪里学会看日本动画的吗？	看动漫吗?	0
你知道我有几个孩子吗？	我猜你也有两个,对吗?	0
是的，爱是美丽的。你没有恋爱，但是？	但是我现在没有恋爱了,我不相信爱情了	0
你什么时候下班？	我不知道啊，我还没下班呢!	0
你什么时候要工作？	我现在已经在工作了啊,你不懂?	0
我来自哪个城市？	河北石家庄，你呢？	1
你骑车上下班吗？	对啊，每天上下班都骑。	0
哦哦嗯	你在哪里呢?美女	0
哦哦对	我觉得苦瓜好苦的	0
那你通常很累，你有空吗？	有啊!但是我不知道你在哪里啊!	0
那很好。顺便问一下，你是大学生吗？	我也希望我是大学生	0
你在哪个城市有小生意？	我在上海打工,现在回家过年,过完年回上海继续打工	0
那你一般讨厌做些什么呢？	你是说讨厌做一些事的意思,还是说,我不喜欢做什么事?	0
呃，好吧，不过像大米饭或者面这些主食品你应该不会也拒绝吧？	嗯,我是拒绝的	0
今天周末我忍不住又去购物了，我喜欢购物，你讨厌吗？	你讨厌逛街吗?	0
约会是星期几？	星期五晚上，星期六晚上都有约了!	0
嗨嗨嗨	嗨，嗨，嗨!	0
啊哦	足球是最爱	0
你不是在冲浪吗？	对啊,群里你叫啥啊	0
我在吃我最喜欢的寿司！你喜欢吃什么？	我也喜欢吃!但是不知道吃什么!	1
我现在最大的爱好就是摄影和徒步旅行，你讨厌吗？	不讨厌，很喜欢。	0
~	不会啊,那只是你自己想多了	0
那你女友接受不了异地恋吗？	我都不知道我有女朋友是什么感觉	0
你厌烦看谁的电影啊？	都不喜欢，不过最近看的是《芳华》	0
你知道我多大了吗？	不知道，你多大？	0
你说得对。你会玩游戏吗？	会啊，而且我还很厉害的	0
你就是这么想的。这位老人退休了吗？	不是我这么想,是我听到的	0
你知道我通常什么时候起床锻炼吗？	额,我不知道,我又不是你肚子里的蛔虫	0
你好，你还没睡吗？	是啊!你也是啊!	0
你讨厌听什么类型的音乐呢？	不喜欢的,都不喜欢听	0
对吗	嗯嗯,我也是这么想的,可是,我也不知道怎么瘦呀	0
我喜欢听李宗盛写的歌。你不认识李宗胜吗？	不认识、你要介绍吗	0
你一定很喜欢狗吧？	是啊,特别爱狗,家里养着一只	0
你是做什么的，叔叔？	我是老师，也是学生!	1
你多大了？	我今年刚满十八岁，你呢？	0
我来自北京。我听说东北部有很多少数民族，是吗？	是的，还有很多东北人在北京!	0
啊好	唱一首听听呗	0
你还在学校。你在几年级？	哦,好吧,你是哪个学校的?	0
仍然很忙。你是做什么的？	我是做财务的，你在哪个城市？	0
你是社会工作者吗？	是啊,社会工作者	0
我更喜欢听古典歌曲。你喜欢什么歌？	我喜欢好多歌,但是最喜欢的就是钢琴曲还有小提琴曲	0
有一个宝贝，你今天没有放工吗？	没有啊,今天星期六	0
你多大了？	你猜啊，猜对了我就告诉你!	0
开演多久了？	一个月了差不多	0
呃	呃什么?有那么无语吗?	0
紫禁城在哪里？	在故宫博物院里，有一个紫禁城遗址	0
你害羞吗？	不害羞，只是没什么好说的	0
你喜欢听谁的歌？	五月天!	0
？？？	医生怎么说?现在怎么样了	0
好吧，不经常。你有最喜欢的歌手吗？	没有，只有老歌，老歌听的比较多	0
我喜欢什么季节滑雪？	不知道，我也不知道!	0
老挝人叫什么名字？	老挝人名字不重要，重要的是你的名字!	0
我可是土生土长的当地人，那警察哥哥你业余时间有没有爱好？	没有，我喜欢睡觉!	0
你家有几条狗？	三,一大一小	1
嘻嘻嘻	你喜欢什么类型的歌？	0
你要去哪个城市？	北京啊，我在北京呆了一个月了!	0
你知道我有多少只猫吗？	三只?两只英短,一只美短?	0
你喜欢谁？	汪峰啊	0
咳咳咳	这就是我的生活啊	0
那你很优秀啊，你在大学教的是什么专业？	我的大学没有教什么专业啊	0
你知道谁在看什么吗？	不知道啊,你说吧	0
你今年多大了？	我是一个有节操的人,不能告诉你	0
谁是流行歌手？	李克勤吧	0
看电影呢，你讨厌看电影不？	不喜欢，因为我不喜欢一个人看电影	0
你知道谁是我最喜欢的主持人吗？	不知道,你说出来吧	0
那你身边的友人一定也和你有相同的爱好吧？	嗯,都差不多,不过我的朋友比较少	0
你知道我在哪里工作吗？	我不知道，我只知道你在这里工作。	1
对了	你也是上海的？	0
啊	我喜欢旅行，喜欢一个人的旅行!	0
你是哪里人？	我是杭州的，现在在杭州上学!	0
你为什么不去那里？	因为我不知道怎么去啊!	0
你什么时候休息的？	上午9点到下午6点!	0
是的，我觉得你不高。你有1.6米吗？	没有，只有一米五!	0
那你都喜欢哪个流行乐演唱者啊？	我喜欢听老歌，不喜欢流行乐	0
哇呜	你多高多重,我感觉我有点胖了,所以不想找工作,先减点	0
你知道我什么时候睡觉吗？	你什么时候睡呢	0
你爱上了这位同事。他能感觉到你非常爱他吗？	我也不知道啊,他没和我说过什么,但他说他最喜欢的女人是我	0
那业主去饭局一定会带着你吧？	不会的，我都是自己去的。	0
你找到漏洞了吗？	没有，我只是想告诉你，我有很多漏洞	0
我现在住在哪里？	我也不知道，我在唿和浩特!	0
你在哪里学习？	我在贵州的一个小县城，你呢	0
你通常什么时候去上班？	这个就不知道了，看情况吧!	0
你知道我什么时候跟父母讲笑话的吗？	你不是说今天吗	0
你知道宿舍里有多少人吗？	不知道。	0
那你很厌烦警片吗？	还好，只要不是太恶心的就行!	0
你知道最大的猫多大了吗？	我在北京,你呢?	0
你已经在工作了吗？	嗯,我也大一	0
你属于哪个团体？	我是武警部队的，你呢	0
你喜欢摇滚乐？	不算吧,我喜欢有磁性的男声	0
嗨，请问你可以给我推荐一些好的劳作吗？	这个,我都没有工作,你让我推荐什么,我现在连饭都吃不起,哪来的劳作	0
你赢了多少元？	五块钱，我赢了六块钱	1
你知道我是哪里人吗？	不知道,你是哪的呀?	0
你通常在家做什么？	吃饭,睡觉,玩手机,玩电脑	0
你知道我什么时候才是成年人吗？	什么时候成年,你爸妈都不容易	0
你知道一个不折不扣的北京人是什么意思吗？	不知道，我只知道我是个外地人	0
~~~	哦哦,知道啦,你要加油哦	0
就叫我小明吧。你叫什么名字？	我叫小青，你呢？怎么称唿？	0
哇，太好了。你有什么爱好吗？	我喜欢旅行，喜欢摄影，喜欢旅游	0
那你听过恶妹妹乐队的歌吗？	这个乐队我知道,但是没听过歌	0
所以你现在是军人了。你没有女朋友吗？	有啊!但是我不喜欢啊!	0
你是哪里人？	我是河北人，现在在北京工作!	0
是的，你是做什么的？	我是做软件开发的，你呢	0
你有空的时候喜欢听什么样的音乐？	纯音乐咯,你呢?	0
你在哪里学习？	我在贵州大学城这边，你呢	0
你好，你是哪里人？	我是河北人，在北京上学!	0
位于马绍尔群岛的岛屿叫什么名字？	东极岛啊	0
。	我是问这个是哪个地方的方言?	0
他打了多少次电话？	不记得了，好像是两次吧。	0
嘘	我喜欢的太多了,不知道怎么说啊	0
我来自甘肃。你从哪里来的？	我从西峰来	0
呸	哈哈,我喜欢美女,不喜欢帅哥	0
你知道我加入了哪个队吗？	不知道啊，你自己说的啊	0
哦对了	你在哪上班呢？	0
哟	我妈很爱我的	0
哈咯啊	你是军哥哥吗?	0
你今天不想工作吗？	工作啊,现在就在工作	0
你是干什么劳作呢？	我是做室内设计的，现在在一家设计公司上班!	0
那你是在什么地域上看呀？	这个我还真不知道!	0
你现在有时间学习吗？	我大四了啊,时间还是挺多的,不过感觉有点晚了	0
我认为是这样。你在工作吗？	没有,我是个闲人	0
你在哪里滑雪？	我在北京和黑龙江滑	0
我喜欢。你不是吗？	我不是，我只是喜欢和你聊天而已。	0
这个挺有趣的，那你现在是在放工吗？	是啊，放假了!	0
哼	别生气，我只是想和你聊聊天。	0
你在哪类公司工作？	我是做审计的，你是做什么的？	0
你今年几岁？	比你大，比你小，比你大!	1
当然，我觉得我很开心。你结婚了吗？	我还没有结婚呢	0
我也喜欢音乐。你最喜欢黑豹乐队的哪首歌？	那太多了,黑豹的歌都很喜欢	0
那你为什么不去呢？你现在忙吗？	嗯,现在忙着毕业,所以就没有过去	0
你可以说话。你不喜欢谈论什么？	我也不知道什么不喜欢	0
你一直在听的歌是谁写的？	林宥嘉	0
呃呃	你现在工作的怎么样?	0
在	你是做平面设计的吗？	0
你的劳作放假时日很长吗？	我想应该很长吧	0
问你几岁方便吗？	不方便，因为我不知道你几岁	0
太好了。你今年几岁？	我已经满22岁了。	0
什么是学位？	我不知道你的学位指的是什么	0
忙什么劳作呀？	忙着做资料什么的,很琐碎	0
你知道我什么时候喜欢在公园看书吗？	我不知道，我只知道我喜欢你!	0
你把你的家人养得胖乎乎的吗？	我爸妈都是瘦瘦的!	0
？？？	是啊!快了!呵呵!	0
嗯嗯	你是在哪啊?现在是做销售吗?	0
有多少人？	不知道，看心情吧!	0
我也是哎，那你怎么不找男友啊？	不想找啊	0
你知道班上有多少个孩子吗？	不知道!	0
你什么时候去训练的？	今天下午啊!	0
你知道我什么时候可以去钓鱼吗？	不知道。	0
你好，新朋友，你在玩游戏。你不用去上班吗？	不用啊，我不玩游戏的	0
哇，这些动物很可爱，不是吗？但你住在哪里？	是的啊,我是问你在哪里	0
你说你喜欢美食，山西你有啥自荐的吗？	我喜欢凉皮肉夹馍凉皮凉面!	0
好吧，我会的。你不再工作了吗？	我现在在上大学,大三了,还有一年半实习,	0
有多少科目低于平均水平？	我感觉我除了英语,其他都很平均啊,除了英语	0
你看了什么电影？	《药神》和《活着》	0
。。	你还没下班啊？	0
你不是在找工作吗？	嗯,在找,你有什么好工作?	0
除了音乐创作，你还喜欢做什么？	看小说,睡觉	0
我喜欢谁的相声？	你喜欢谁我就喜欢谁!	0
嘿嘿对	我学的是汽车检测与维修	0
那你讨厌什么运动？	没有讨厌的运动,我不运动也不讨厌运动	0
我通常喜欢在晚上下班后散步。你不喜欢走路吗？	喜欢啊,我每天都要步行一公里左右,不喜欢坐车	0
你非常喜欢听布鲁斯音乐吗？	我觉得布鲁斯很好听	0
我不太注意乐队。你喜欢吗？	还好,没有特别喜欢的	0
你现在的工作是什么？	我现在是一名小文员，呵呵!	0
周星驰的助手是谁？	是不是有一个演员是演功夫里的小结巴,还有个叫什么来着,忘了	0
那你都是卖什么脂粉的呢？	我不卖脂粉	0
你知道我多大了吗？	你不是说你16,我也16啊	0
如果你继续这样下去，你会变成一个没用的人。你一个人吗？你的家人关心你吗？	我会关心我的家人，他们关心我就够了	0
你多大了？	我说呢,吓我一跳	0
哇，你喜欢摩托车吗？	不喜欢，我只喜欢你!	0
夜曲是谁写的？	不知道，只知道是肖邦写的。	1
你在做什么？	我在做外贸业务员，你呢	0
谁是中国流行歌手？	我也不知道，我只是喜欢她的歌	1
92年你多大了？	我是91年的，比你大一岁。	0
哦，你要出去玩吗？	是啊，去哪玩啊？	0
你知道孩子五岁是哪一年吗？	不知道，我也想知道	0
管理网店需要几个月？	看你怎么经营了,我加盟的,现在不都是这样	0
哦哦，这样啊，你是放工路上经过这里吗？	没有,不去那边	0
你是哪里人？	我是四川的，现在在湖南读书!	0
没事没事，你小时候有啥梦想呀，破灭了吗？	小时候的梦想是能当一名伟大的科学家,现在实现一半了	0
你不想做点好吃的吗？	我想做给你吃，可是我不会做!	0
你在哪开的酒吧？	武昌天地那边，叫什么我忘了。	0
嗨，今天这里是蓝色的。那里的天气怎么样？	阴天，不过阳光很好，心情也很好!	1
那你厌恶民歌是吗？	不厌恶啊,就是听不习惯	0
我家有多少条狗？	你家有几条狗啊？	0
你在干什么？	哈哈,那你的收入一定很不错吧?能不能告诉我?	0
好	不过你要请我吃蛋糕的话我还是更喜欢吃黑森林	0
你星期几去姐姐家？	星期六吧，我还不知道。	1
哦，你多大了？	我比你大，我26了!	0
哦对	你喜欢打什么球？	0
你最近听了谁的歌？	赵雷的,宋冬野的,还有一些民谣歌手的	0
你要去哪里？	我要去的地方多了	0
士兵在哪里？	在北京啊，你在北京吗？	0
你知道一家上市公司的CEO有多少个孩子吗？	我知道啊,我们家的一家四代都是上市公司的,孩子太多了	0
你毕业于哪所学校？	我还没有毕业,大三	0
嗨喽啊	嗨喽啊，你在哪儿呢？	0
你练了多少年？	两年多啊	0
你什么时候进来的？	刚进来的，你有什么事吗？	0
谁是传奇人物？	甄嬛啊!你不知道吗？	0
你知道我工作的工厂在哪里吗？	不知道，你是做什么工作的？	0
你上的是哪所院校啊？	说了你也不知道,在湖南	0
你知道我更喜欢哪个乐队吗？	不知道,但是我喜欢的乐队你也不会喜欢,你说吧	0
谁是流行歌手？	陈绮贞，梁静茹，陈绮贞	0
你知道我每天什么时候工作吗？	不知道，我只知道你是策划!	0
你知道我是哪里人吗？	不知道,但是可以认识你啊	0
那你为什么不这么做？	我也想啊，可是我不知道怎么做	0
好的，我喜欢川菜。最近，该公司在楼下新开了一家。你可以试试。你喜欢辛辣的食物吗？	我不喜欢!但是我爱吃辣!	1
是啊，非常喜欢编程，对了，你是做什么劳作的呢？	我是做汽车销售的	0
电影中的两只狗叫什么名字？	不知道，我没看过	0
我在开玩笑。狗不会被扔掉。你必须保留它们。你什么时候结婚的？	我已经结婚了，谢谢!	0
哇，太棒了。你在海军服役多久了？	一年多了。	0
~	哦哦,有没有想去西藏的冲动?	0
你想出去吗？	我不知道想去哪里?	0
你打算怎么办？	不知道呢,我都不知道我到底是不是在跳舞了	0
你的店开了多久了？	快两年了吧，你呢？	0
你还喜欢看卡通片呀？	是啊，还有什么卡通片推荐吗？	0
你是哪里人？	我在上海上学，现在在上海工作。	0
你知道我是哪个队的教练吗？	不知道,哪个队嘛	0
我每天什么时候上班？	早上9点到晚上6点	0
我什么时候去兜风？	随时都可以!	0
你知道我有几个儿子吗？	不知道啊,几个	0
我不知道目前该找什么工作。你是做什么的？	我是做网站的，你在哪个城市？	0
当你还是个孩子的时候，生活应该很艰难吧？	是啊，所以我现在很珍惜现在的生活。	0
你一个人长大不容易。你现在怎么样？	还好吧，挺好的!	0
你每天工作要花多少小时？	八个小时吧,不过有时候很闲,有时候忙	0
我同情你。你养什么狗？	我养的拉布拉多,金毛	0
对啊	我喜欢长得帅的	0
我一看你就是一个很聪明的人物，你是做什么的呢？	呵呵、我也是没事做,整天在家,玩呢	0
我没有，你吃过了吗？	我刚吃完回来了	0
到机场花了多长时间？	一个半小时，不过我是从北京出发的。	0
…	我也有这本书,看了一半了	0
你知道我有几条狗吗？	不知道啊,怎么了?	0
你不想出去吗？	想啊，只是没人陪我玩	0
你知道我多大了吗？	我不知道啊,你多大	0
下雪要多长时间？	我也不知道，我只知道下周会下雪。	0
那你一定很懂菜吧，最好最有营养的菜是什么啊？	我不懂,我只知道我吃的	0
你好，朋友，看，你买了很多渔具。你喜欢钓鱼吗？	是啊,就是喜欢钓鱼	0
你的酒吧在哪？	在我家旁边，就在我家对面!	0
你推荐的学校叫什么名字？	我看了一下,觉得学校都是差不多的,所以不知道该怎么选	0
是的，你今年多大了？	你是哪个地区的?我是浙江的	0
你是哪里人？	我也是在广州啊	0
你知道我最喜欢的语言是什么吗？	西班牙语吗?	0
小青的真名是什么？	我叫小青，你叫我小青吧!	0
你知道我弟弟是哪个军种的吗？	不知道啊,我只知道他们是海军	1
你第一次来这里是什么时候？	我刚来这里的时候。	0
这是编辑的基本要求。嘿，你不工作的时候做什么？	写稿子，写文章，看书，看电影!	0
哦对	买个吉他,然后上网找点教学视频	0
是的，你呢？你多大了？你的梦想是什么？	我今年25岁了，希望家人健康平安!	0
你最喜欢他们的哪种音乐？	最喜欢的是,我很想爱他,和,我想我是海	0
你怎么在家劳作这么自由呀？	我也不知道呢,我也没有干过什么事啊,只是偶尔在家做做家务吧	0
你知道我在哪里毕业的吗？	不知道啊，你是哪个学校的？	0
那你为什么不把它绑起来？你不能把它分开吗？	你没绑过吗,你不知道,你绑了就知道了	0
你还在招聘吗？	在啊!你想应聘什么职位？	0
你什么时候跑步？	晚上7点到8点之间	0
很好。你上过大学吗？	我是小学生,我没上大学,我在上小学	0
那你一定擅长钓鱼。你一次能抓多少？	没算过,反正有鱼就行	0
嗯嗯对	那就好，我还以为你不在呢!	0
你的工作非常神圣。除了工作，你还有什么爱好吗？	喜欢养花,养猫!不知道算不算?	0
你喜欢哪个城市？	我喜欢的城市太多了，我不知道!	1
买一辆车要多少钱？	一万左右就行了,你有没有什么车	0
诶呦	怎么了？	0
这很普通。你有自己的房子吗？	有啊，现在住的房子就是我的。	0
什么时候？	你想什么时候啊?	0
你和朋友出去吗？	出去啊,我都是去和朋友玩的	0
你多大了？	比你大一岁，比你大两岁!	1
你知道我多大了吗？	不知道,你说说吧	0
你是哪里人？	我是黑龙江牡丹江的	0
有多少人？	不多，只有十几个而已。	0
你知道我喜欢看谁的电影版《爱丽丝梦游仙境》吗？	不知道呢,是谁的电影?	0
你知道我作为实习生加入了哪家公司吗？	不知道。	0
你家里人不多吗？	我和我老公,还有我儿子,不多啊,就一个儿子	0
那你有没有考虑过换一份劳作呀？	考虑过但是不知道能做什么	0
你喜欢哪个城市？	北京，北京，上海，北京!	0
负责调查的人叫什么名字？	我叫王小丽，是一名记者。	0
你知道我是哪里人吗？	不知道，我只知道你是江西的	1
你好，我叫赵武。你叫什么名字？	我叫赵恒，你呢!	0
你去过哪座山？	华山，华山。还有华山下面的山。	0
你知道她每天跑多少公里吗？	不知道，我也想知道。	0
是的，那你们平时工作会闲吗？	闲的时候很闲，闲的时间很少!	0
你是哪里人？	我在青岛上学，现在不在青岛了!	0
你是哪里人？	我是广东人，在深圳工作!	0
你通常什么时候工作？	我一般都是早上九点到下午五点	0
有多少人？	我21,你比我大,你哪里人啊?	0
你知道我多大了吗？	不造诶,你几岁	0
你知道我唯一没去过的地方是什么吗？	不知道!	0
你知道我养的那条狗叫谁吗？	不知道!是谁?	0
我喜欢火锅。我觉得很好。你怎么认为？	我也觉得他不错的呢	0
是的，我通常非常喜欢钓鱼。你喜欢做什么？	我喜欢睡觉,打篮球	0
你在哪里工作？	我在上海，目前在一家外资企业上班。	0
你知道什么是翻译吗？	不知道，我只知道有翻译这个专业	0
那么你的身体状况很好？	还好，只是偶尔会生病。	0
你研究过这个地区吗？	你说的是什么地区?	0
我是李强。你从哪里来的？	安徽,宿州	0
是的，你的家人呢？	哦哦,我家是吉林的	0
哦呦	那是你的想法吧	0
你知道茶什么时候让我精神振奋吗？	不知道，我也想知道。	0
我什么时候考虑吃什么？	你不吃的时候	0
每个人都有自己的爱好。碰巧我的爱好是阅读。你喜欢什么？	我喜欢听音乐,喜欢看电影,喜欢吃,你呢?	0
嗯，你通常有假期吗？	有啊,我是轮休,我的假是上一天休两天	0
嘿，嘿，你通常不喜欢做什么？	我不知道，我喜欢睡觉	0
什么时候在城里散步好？	这个就不知道了，没去过!	0
你没时间出去。你基本上是怎么做到的？	我也想问这个问题!	0
你家有几个孩子？	两个，一个弟弟，一个妹妹!	0
这个生物多大了？	现在一岁多点	0
他走了多少步？	不知道，没数过。	0
你薪水高吗？	那你有没有想过要改变	0
你是哪里人？	我是湖南岳阳人,在深圳上班	0
哈咯啊	哈喽,还没睡觉?	0
你一个月工作多少小时？	没工作呀,我是自己做的小网店,一月也有三四千,不比上班工资少	1
我也是。你吃早餐了吗？	我吃过了。	0
你有一头牛吗？	有啊，我家养了一头牛!	0
这房子有多少间卧室？	一室一厅一厨一卫	0
你知道我失去了什么吗？	失去了一个小姐姐	0
我又在喝下午茶，喝奶茶，吃甜点了。我喜欢糖果。你呢？	我喜欢吃糖!	0
女人的年龄是多少？	这个还真不好说，要看具体的年龄。	0
你教的是什么专业？	管理科学与工程，你呢	0
买一辆车要多少钱？	一万左右就可以啊	0
是这样的。你是做什么的？你为什么这么累？	我是做网店的,因为每天都要在电脑面前看着订单,所以就很忙	0
那你很厌烦警片吗？	不啊!我很喜欢看的!	0
事实上，我只是想问你最近有没有什么好的外国电影推荐？	我都忘记了,有什么好看的电影么,你推荐下,我去看	0
你知道菊花在什么季节开放吗？	我知道啊,秋天	0
你多大了？	我22了。你呢？	0
你们在一起多少年了？	在一起三年多了。	0
在杭州，我们公司仍有光明的未来。你不想来杭州发展吗？	我想去杭州，可是我没钱。	0
是的，我最喜欢的运动是骑自行车。那你呢？你的爱好是什么？	我喜欢跑步，游泳，看书，听音乐!	0
你在哪？	我在上海呢，你在哪儿呢？	0
你的工作怎么样？	还行吧!	0
你做销售有多少年了？	我是做了两年了,现在自己开了一家公司,现在是负责管理的	0
你知道高考后我现在去哪里吗？	不知道啊!	0
你研究过这个地区吗？	没有,我只了解广东这边的	0
你知道我最喜欢谁的音乐吗？	当然知道!	0
你知道我加入了哪个队吗？	不知道,哪个	0
你知道我每天什么时候工作吗？	我不知道啊,我又不会算	0
嗯啊	你也在做微商嘛?	0
你喜欢什么乐器？	吉他，尤克里里，钢琴，架子鼓。	0
你知道设计师的薪水是多少吗？	知道啊,我同学就设计的,我是建筑学	0
你知道蜘蛛侠来自哪个国家吗？	美队是英国的,队长是法国的,其他的没研究	0
你知道我多大了吗？	你多大?比我大?	0
你经常看书，还是个学习者吗？	不是,只是喜欢看书,不喜欢学习,你大几了	0
哦对了	嗯，那就好，我还以为你消失了呢!	0
你知道我什么时候开始踢足球吗？	7岁,你现在多大?我7岁的时候也不太会玩,但我很喜欢踢球	0
你是哪里人？	我是吉林人	0
是的，是的，你的着装风格是嘻哈舞者可以穿的。你学嘻哈有多少年了？	我学了10年了，不过我现在已经不跳了	0
可以啊	好啊，你在哪个城市呢？	0
你放工很早吗？	是啊，每天都是九点半到十点半	0
你通常工作压力很大吗？	不大，一般般吧，有压力才有动力。	0
你知道这房子有多少只猫吗？	你知道我家这只猫多少钱吗?	0
学校什么时候上课？	明天下午2点到6点，你可以来找我	0
你知道我要去什么样的地方吗？	不知道。	0
你看过很多集吗？	我只看了几集,还没看完	0
是啊，你讨厌购物吗？	还好啦,就是不喜欢逛街买东西	0
你知道我多大了吗？	不知道!	0
是的，现在我是大二学生了。我通常不上课就出去做兼职，以赚取一些生活费。你是做什么的？	我是杂志社的编辑。	0
嘻	你不知道？那你为什么要来找我？	0
高中三年级是哪一年？	我已经毕业了，你应该比我大吧？	0
我喜欢复古的汽车，你呢，厌恶什么？	我厌恶我自己	0
你多大了？	我今年刚满十八岁，你呢？	0
真是巧合。你学的时候能给我唱歌吗？	当然可以，只要你不嫌我唱的难听	0
你知道我多大了吗？	不知道，所以才问你啊	0
你知道我喜欢什么吗？	你喜欢我,我知道	0
你知道我什么时候和朋友去潜水吗？	不知道，只知道你喜欢	0
你的家人是上海人吗？	不是，只是在上海读书而已。	0
你是如何进入微博行业的？	我也想知道!	0
你不看什么样的综艺节目？	我不看电视，所以不知道啊!	0
啊，你病了吗？	是的呢,病了好几天了,你要来照顾我吗?	0
你知道程序员的智商是多少吗？	不知道,你知道吗	0
是呢	你好，我是小雨。	0
那你想找什么样的劳作呢？	只要不是销售,都可以	0
你什么时候上的大学？	我还没上过大学呢	0
你什么时候要工作？	不知道，等通知吧!	0
不累，别总说我了，你是做什么劳作的？	我是做软件开发的，现在在一家互联网公司上班!	0
哇哇哇	你多大了？	0
哦哦嗯	你也不好?	0
你知道我是哪里人吗？	不知道啊!	0
我什么时候有儿子？	你还没结婚，我怎么知道？	0
你真的100岁了吗？	对啊!我是千年老妖	0
是的，我被他们的才华所吸引。顺便说一下，我不知道你是否有工作。你能告诉我吗？	我现在还在找工作，等我找到了再告诉你。	0
当然，我觉得我很开心。你结婚了吗？	当然啦,我觉得我好幸福哦,你结婚了吗?	0
？	对啊，我妈妈很喜欢你	0
那好吧，你们是全家人都搬到北京了吗？	是啊,全家都过来了	0
你练了多少年？	我才一年半,不过已经有一些基础了,所以我想继续练下去	0
那你结业以后是不是要做厨师呢？	不知道啊，我还没毕业呢!	0
我20岁是什么时候？	你自己说的,你自己都忘了	0
你的店开了多久了？	一个月左右吧!	0
哦，的确如此。你是做什么的？	我是做护肤品的	0
你几岁结婚的？	我还没结婚，只是有了孩子。	0
下班后你通常什么时候来？	我通常都是下午三点左右来。	0
你多大了？	我已经21岁了。	0
我看你朋友圈你是在厂子里上班吗？	是的，厂子里!	0
诶呀	咋的了,哈哈	0
你在工厂工作了几个月？	四个月吧,然后辞工了,然后就没做了	0
你没有男朋友吗？	没有啊,我是男的	0
对了啊	你是学什么专业的呢？	0
你想系统地学习吗？	不想，我只是想找个人聊天而已。	0
你通常什么时候休息？	我一般是周六周日休息，你呢？	0
你一个月挣多少美元？	你做了多长时间啊?这么厉害	0
你知道我喜欢听谁的歌吗？	不知道,你是谁啊	0
你毕业于哪所学校？	我在北师大读研，你呢	0
你什么时候去公司开会的？	早上7点多就出发了,到了公司才9点左右	0
你叫什么名字？	我叫王玉清，这个名字怎么样？	0
不是吗？你养什么狗？	我养的是拉布拉多!	0
我也是哎，那你怎么不找男友啊？	因为我喜欢的是女人	0
你不是工程师？	我不是,是助手	0
嗯，是的，你经常锻炼吗？	偶尔,也不经常,因为我懒	0
你和你妈妈都是老师？	是的，都是我妈妈教我的	0
我最喜欢谁？	秦霄贤啊!你不知道吗？	0
你知道我多大了吗？	不知道，你多大了？	0
职业球员，有这样的职业吗？	有啊,不过好像是有要求的	0
你知道我什么时候有女儿吗？	那你是在逗我喽?	0
你好，聊天吗？	你好,可以啊	0
我喜欢听任然的歌，你有讨厌的歌吗？	没有，只要是她的歌我都喜欢!	0
你什么时候进来的？	我也不知道，最近才进来的!	1
一个人什么时候能结婚？	不知道，我也想知道。	0
你过活挺丰富的嘛，你劳作了吗？	没有啊，我还在上学呢!	0
你说的语言叫什么？	我说的是广东话，你是广东人吗？	0
你知道我最喜欢的乐队是什么吗？	不知道啊,难道不是五月天?	1
你知道我什么时候开始学习的吗？	0岁?不是吧?	0
是	那你想聊什么呢？	0
呜呜呜	你也可以做销售呀,只要有上进心,肯学,就可以了	0
买这台平板电脑花了多少钱？	我不知道，我没买过。	0
你想去哪里？	你在哪?我在天津,有推荐的吗	0
那你们是自己开车回的吗？	是的!	0
你不厌倦每天养宠物吗？	不会啊，我每天都带它们出去玩的	0
你不是去过很多地方吗？	我去过的地方很少啊,你看错了吧	0
你知道我有多少只小狗吗？	不知道!	0
工作地点在哪里？	上海啊，还没定下来呢。	1
学生在哪里？	我在北京,我就是学生	0
这是一项艰苦的工作。你不打算换工作吗？	不知道啊!我也不知道自己想做什么!	0
呦呵	那你现在住哪啊	0
你不是经常有看小说的习惯吗？	嗯，是啊，不过我很少看小说。	1
有多少人在岛上工作？	不知道，我没去过岛上。	0
哈哈~	你家狗叫啥名字？	0
你不适合什么行业？	销售和管理	0
有多少人？	就我一个，其他都是认识的人!	1
嗨喽	你是我最美的风景	0
但我现在很无聊。你能给我推荐一些有趣的东西吗？	你喜欢什么样的？	0
我没有最喜欢的乐队。你能推荐一些好歌吗？	那就太多了,我的歌单里面有上千首,而且我是比较喜欢听老歌的	0
紫色会不会太炸眼呀，你爹妈愿意你染头发吗？	我爸妈也很开明	0
你现在有更高的薪水吗？	没有，我现在是无业游民。	0
参加过中国有嘻哈，你看过这档剧目吗？	看过,他有一首歌也唱过	0
他在哪里？	他家在江苏	0
你是北方人吗？	我是东北人，在北京工作!	0
哦~	哦,那你是比我小咯?你是哪里人啊?	0
好的，你没有兔子吗？	我没有兔子啊,我是想领养一只	0
你工作这么闲的吗？	是的,闲	0
对	我都是一上车就开始紧张,到后来就好了	0
你为什么那么不喜欢院校呀？	学校没有想象中的那么好	0
你的孩子在几年级？	我还没有孩子呢	0
哪座岛最远？	海南岛最远，因为我没去过!	0
那很好。你自己吃饼干吗？	是啊!自己做饼干吃!	0
你好，你现在是上班还是上学？	你现在是在上班还是上学?	0
你不喜欢网上购物吗？	买东西,不是购物	1
你有孩子吗？	有啊，你要来玩吗？	0
你工作时经常在哪里吃饭？	我是大一的,还没有工作	0
你听说过五月天吗？	没有啊，我只听过他们的歌	1
看过不太喜欢，我喜欢看喜剧类型的，你讨厌看什么类型的？	喜剧类的都不喜欢，最喜欢喜剧	1
可以呀，那你都厌恶听谁的歌呢？	周杰伦啊，五月天啊，王力宏啊	0
我什么时候有儿子？	你不是有两个儿子吗？	0
你要等多久？	我想的是再等一等再放弃,但不知道是多久	0
你知道我什么时候去健身房吗？	不知道，你是男的？	0
哦，你想过工作吗？	想过,可是一直没行动	0
哦哦，那你这一个钟头都会做些什么？	发呆吧,或者看电影	0
哦，你不喜欢哪一位作家的书？	没有不喜欢的,除了郭敬明	1
那你有什么厌恶做的事情吗？	不,我最讨厌的就是玩游戏	0
！！！	你说是什么狗	0
开学的第一天是星期几？	星期一,怎么了?	0
你看了节目的哪一集？	看了第二集	0
你知道我搬到北京时多大了吗？	不知道!	0
好！	你在哪个省呢?	0
你喜欢听谁的歌？	周杰伦啊!	0
你一定要上课吗？	那也没办法,谁叫我没本事呢	0
哟呵	你是不是把螃蟹都给我了	0
哦？	我看电视、上网、看书、睡觉...	0
我最喜欢的乐队是什么？	不知道,对这个不感兴趣	0
你有几个姐妹？	一个，还有一个弟弟，还有两个妹妹	1
你通常做什么？	打豆豆是什么意思？	0
我的朋友，你喜欢读书吗？	我喜欢，你呢？	0
嗯啊	那挺好的,你是怎么做的可以教我吗?	0
我喜欢音乐。你呢？	我也喜欢,但是唱的不好就是了,我唱歌会要命的	0
你喜欢谁？	东野圭吾,渡边信一郎,川端,村上春树,村上的书看的比较多点	0
这么长时间你在干什么？	我在学习,我想我会在那里一个人也不认识,我会很开心很快乐	0
我有多高？	你有多高我就有多高!	0
嗨喽啊	你也可以的，只要胆子大	0
那你厌恶民歌是吗？	不厌恶,我也喜欢民歌	0
你多大了？	那你还是叫我哥吧	0
您好，你觉得这个东方明珠怎么样？	挺好的，我很喜欢!	0
为什么我觉得你看起来很面熟？	因为我也在找你啊!	0
你多大了？	我24了，今年刚过完22岁生日。	1
诶呀	真的,你会遇到的	0
没什么特别的吗？	特别的,不就是各种鱼吗?都挺特别的啊	0
是的，那你平时除了工作都讨厌做什么呢？	讨厌的东西多了,你要给我介绍个男朋友吗	0
你在哪里工作？	我在北京，你呢	0
那我很荣幸，看来我们很无缘，那你平常有什么兴趣爱好呢？	我的兴趣爱好,就是,吃,睡	0
你还要上多少次厕所？	不知道，没数过	0
有多少米？	一米八的身高，一米七的身材，一米五的脸	0
你通常一周做几次？	看情况吧，有时候一天两次有时候两天一次。	0
你会像水壶一样胖吗？	那倒没那么胖	0
那你是怎么厌恶上歌剧的？	因为我不喜欢歌剧，所以就不喜欢了。	0
我不喜欢模仿别人的东西，你经常看影视？	是啊，你也喜欢看吗？	0
有多少种不同的啤酒？	好像有十几种吧，我只喝过一种。	0
你什么时候毕业？	明年六月份吧。	0
你知道我非常喜欢谁吗？	不知道，我只知道你很喜欢她	0
我父母是银行行长。他们通常很忙。我有时间开宝马去接他们。你呢？	我也是!	0
我现在是一家超市的总经理。你没有什么爱好吗？	我喜欢逛街，买衣服。	0
那你通常很累，你有空吗？	有啊!怎么了？	0
那是一个很厉害的校园，你有把握吗？	我觉得我可以冲一下,就是专业可能不好	0
是的，你是做什么的？	我是做电子商务的，你在哪里？	0
天哪，你真勇敢。你有两个孩子和一只猫。你丈夫是做什么的？	做工程的	0
你知道我来自哪里吗？	我知道,你是从火星来的,你的飞船被我发现了	0
哟呵	你也喜欢运动吗？	0
你玩了几天？	5天,你去了吗?	0
你开餐饮店一年大概可以赚多少钱啊？	这个我不太清楚，因为我没有开过餐饮店	0
你知道我为哪个队效力吗？	不知道!	0
恋爱时你在哪里？	在北京啊，这个问题问的好。	0
晚上好你还没休息吗？	是啊，我还没有休息呢!	0
你今年几岁？	我已经22了，你呢	0
你能花多少美元买一台立体声音响？	这个就不知道了，我没买过	0
你知道我更喜欢哪个乐队吗？	黑豹?	0
川菜来自哪里？	成都啊，四川人都会吃辣的!	0
三年级的学生人数是多少？	我不知道，我没教过学生。	0
你知道我18岁生日是什么时候吗？	不知道啊!	0
嘿，我刚从花店买了牛奶糖。你不想吃东西吗？	牛奶糖？	0
学校什么时候上课？	明天上午9点到下午4点	0
我家有几个孩子？	两个，一个大的，一个小的。	0
我也好想去成都，听说成都的一品锅很好吃，你们去吃了吗？	没吃!我下次去吃	0
你什么时候做了一件重要的事？	今天早上，我去了一个很远很远的地方!	0
你知道我最喜欢哪部电影吗？	不知道!	0
呃呃	我也不知道怎么办了,现在	0
你是哪一年来的？	你比我大,我九六年的	0
你最喜欢的电影有多少？	不知道,反正没有最喜欢,没有最不喜欢的	0
你也是马拉松爱好者？	嗯，是的。	0
你好呀，我想和你交个友朋，好不好呀？	好啊!我们做盆友吧	0
你来这座城市有几个月了？	我在这待了快一年了快回去了	0
谁是神秘小说家？	东野圭璋。他的书都挺好看的。	0
你通常喜欢做什么？	吃饭，睡觉，打豆豆	0
你吃素很久了吗？	是啊，从出生到现在。	0
你什么时候去上班？	我已经上了两天班了,你在哪里上班?	0
你知道我通常什么时候吃一个苹果吗？	不知道,你也不说	0
是的，我在这里工作多年了。你不一样吗？	我在海淀，你呢？	0
那不好意思啊，我之前不知道，不说这个了，你最厌烦吃什么啊？	没什么,我什么都吃,不挑的	0
你什么时候去看电影？	今天不行，明天吧!	0
哇，你在哪个部门？	我在急诊科，你呢	0
哇啊，你好有酒兴啊，你平常在哪钓鱼啊？	我一般在河边钓鱼，你在哪？	0
很高兴认识你。你吃过晚饭了吗？	我吃过了。	0
你知道我可以去哪里兜风吗？	我只知道你可以开着这车带我兜风	0
我想开我家的车去自驾旅行。你不喜欢什么样的旅行？	我喜欢安静的，不喜欢拥挤的!	0
呵	你是怎么把你家孩子养的那么胖的	0
休息时你喜欢做什么？	发呆，看书。	0
你来这座城市有多少年了？	我从出生起就在这里了	0
你什么时候毕业的？	15年,今年大一	1
你有几个孩子？	一儿一女,儿子才两岁	0
你为什么喜欢看恐怖小说？	因为我喜欢这个世界上的人。	0
你能每天都这样睡觉吗？	我也不知道，反正我是这样的	0
哦呦	哦呦是什么意思呢	0
你知道我妻子和我谈恋爱花了多少年时间吗？	我不知道，我只知道你是个医生。	0
你是哪里人？	我是北京人，现在在北京工作!	0
我是大二学生。你多大了？	我也是大二的，你呢？	0
哼	看你的照片吗?	0
你每天工作多长时间？	我工作时间不固定，一般8-10个小时吧!	0
难道你就没有那种想看很多遍的影片吗？	有啊，我都看了好多遍了	0
你的生活复杂吗？	不复杂，只是偶尔会有些感慨。	0
当然你为什么这么累？	我不知道，我也不想知道!	0
你知道我来自哪个城市吗？	不知道，我只知道你来自东北	0
你一个月不应该有很多薪水？	我又不是卖唱的,哪有薪水	0
你知道我喜欢谁的歌吗？	不知道耶，我只知道他的歌都很好听	0
你知道他妻子多大了吗？	不知道，我只知道她比我大四岁。	1
你是哪一年的？	91年12月的，你在哪里？	0
你经常卖彩票吗？	我不卖彩票，我卖的是生活!	0
谁是流行歌手？	王力宏啊，你不知道吗？	0
你知道我喜欢什么节日吗？	那你说说,看看我知不知道	0
这么厉害啊，那你可能见过很多的明星吧？	也没有啦，只是见过很多次而已	1
有多少人？	很多人啊，都是90后吧？	0
你就是这么想的。这位老人退休了吗？	没有啊,我也不确定,只是我觉得他是退休人员	0
什么时候出《什么来了》呢？	这个还真不知道，我是在网上看到的	0
你一个月只休息两天。你不累吗？	不累,习惯了	0
一个人昏迷了多久？	昏迷了五个月吧,醒了以后就一直吐	0
你知道我喜欢听什么吗？	不知道,我知道我喜欢听什么就可以了	0
哪里的环境很新鲜？	西藏的天很蓝	0
那很好。你是做什么的？	我是做销售的,做了好几年了,现在想找份工作	0
那个问你一个问题，一见钟情，你相信吗？	钟脸的时候信,钟情我就不信了	0
你知道我最喜欢吃什么样的快餐吗？	难道是那种一个汉堡加一个鸡腿的套餐?	0
但你真的不努力学习吗？	我想说一个月前我还是一个学霸,现在我已经堕落了	0
你儿子在哪里？	我儿子不在北京，在北京的部队。	1
你什么时候毕业？	我现在在实习,明年毕业	0
你知道我多大了吗？	我也19,你应该和我一样大吧	0
你忙了几天？	从上个礼拜六开始的,到现在吧	0
你什么时候满28岁的？	我也不知道，我一直都是这么大的。	0
她不知道你要离婚了吗？	她还真不知道,我都不想告诉她,怕吓着他	0
你知道今天是星期几吗？	今天星期三啊,你不是说你也是学生吗?我在广州读大学	0
你是哪里人？	我是北京人，现在在北京工作!	0
你知道我特别喜欢哪个国家吗？	你喜欢日本	0
你现在是在工作还是在家当妈妈？	在家里当妈妈!	0
噢	那你打算什么时候上班啊?	0
你是哪里人？	我是河北人，现在在北京工作!	0
你知道我什么时候上初中吗？	你应该比我晚	0
你在哪里学习？	我在北京，你呢	0
看起来你追求很高雅嘛，那你有什么名人是最讨厌的吗？	我只说了是喜欢,没说讨厌,你是不是有点断章取义了	0
是的，你吃早餐了吗？	吃了,吃的豆浆油条,还有一杯牛奶	0
你是第一名还是第二名？	我是第二,但是我是第一届的,你是第几届的?	0
你每天在家看小说吗？	对啊，我每天都在看小说啊!	0
我在操场上跑了几圈？	十圈，那你为什么要跑十圈？	0
好吧，我会的。你现在是大一新生了吗？	是啊!你是大几的?	0
你每天打扫房间吗？	不，我偶尔也会打扫。	0
你知道我什么时候出去散步吗？	不知道，我也不知道。	0
主要原因是我没有精力。我厌倦了每天抚养他们。你没有宠物吗？	有啊，我养了两只猫!	0
你好，你现在做什么？	我现在做网络推广的	0
你知道谁唱了我喜欢的歌吗？	你喜欢听啥歌	0
一年中最喜庆的日子是什么？	春节是每个人最喜欢过的节日!	0
这么棒呀，那你有没有参加有关这些棋类竞赛呢？	没有，因为我不喜欢玩这个	0
大一是哪一年？	大一就是今年	0
高三的人数是多少？	我们这一届,高三有600多人	0
你知道我多大了吗？	不知道，反正比我大就对了!	0
你不喜欢去动物园吗？	我不喜欢动物园，我喜欢你!	0
你所在的班级叫什么名字？	你在哪里读书的?	0
你知道谁是公主吗？	不知道，你知道吗？	0
你在哪里学习？	我在天津上学，现在在北京工作!	0
你知道我什么时候上大二吗？	不知道啊!	0
你的篮球技术怎么样？	一般般啦，只是比较喜欢打篮球而已	0
比赛日期是什么时候？	九月11号呀!你来就可以看到了,我是裁判	0
你什么时候喝这个？	早上喝的啊，晚上喝的话会睡不着的	0
你一定要担心天气吗？	对,因为我是要去比赛的	0
士兵在哪里？	在这里，在这里!	0
这孩子多大了？	我儿子三岁半,我儿子也是因为这病才有的,现在已经好的差不多了	0
我是哪里人？	你是哪里的？	0
好的，你是哪里人？	我是湖北人，在武汉上学!	0
你多大了？	我是87的,比你大	0
你不想做什么工作？	不知道啊，我也不知道	0
你通常什么时候打电话？	晚上11点之后，上午10点之前。	0
你知道我多大了吗？	你不是说你15吗	0
。	我不知道你的名字。	0
你知道我是哪里人吗？	你不是说在上海吗?难道你不是?	0
你知道我喜欢什么类型的音乐吗？	不知道,但感觉是有品味的人	0
是的，我通常在没事的时候上网聊天。你通常喜欢什么？	我喜欢看书，听音乐，看书。	0
是的，我非常喜欢。我经常听乡村音乐。你没听见吗？	我听不见,我耳朵坏掉了	0
啊好	那就好,你最近怎么样?	0
我是搞科研的，在生物体研究所劳作，你呢？	我在搬砖中苦逼	0
是的，你应该尽力做你喜欢做的事。你有工作吗？	你的意思是你有?	0
你知道我家的语言是什么吗？	客家话还是白话,我也是客家人	0
你在家一个月挣多少钱？	你真有上进心,羡慕!教教我吧,我也想做	0
嗨	嗨，你好，有什么可以帮到你的吗？	0
你好，你不能说话吗？	可以啊，只是我不知道该说什么!	0
你知道谁是乐队的鼓手吗？	不知道，我只知道李荣浩	0
嘛	羽毛球是我最喜欢的运动!	0
你的家在哪里？	浙江温州的一个小县城。	0
在北京，你在哪？	我在天津，你呢？	0
你和家人有这么多麻烦吗？	我不知道，我只知道我和他们之间有些矛盾。	1
你今天要吃什么？	不知道,可能不吃了,不想下去吃,你呢,你想吃点什么?	0
你说的也对，你的劳作是不是很挣钱呀？	不挣钱，我只是搬运工而已。	0
班上有多少人坐火车？	我不知道啊,没统计,不过我觉得应该不多	0
你现在在哪里上学？	哦哦,我在四川呢	0
我更喜欢听古典歌曲。你喜欢什么歌？	都喜欢,只要好听我都喜欢	0
是的，我更喜欢读书。你不喜欢读书吗？	不喜欢，我喜欢睡觉!	0
喜欢，我有一只金毛猎犬，你厌恶什么宠物？	我喜欢大型犬，不喜欢小型犬!	0
好哇	你在什么地方,你是哪里人啊?	0
你是哪里人？	我是河北人，现在在北京工作!	0
我多大了？	你多大了啊？	0
你应该去哪个城市？	不知道啊!我也不知道!	0
没事，就想找人士说说话，你平时喜欢滑雪吗？	还好,你是男的女的	0
是的，我真的很怀念学生生活。你主修法律吗？	不是,我辅修的法律,我主修经济法	1
哦，哦，你不是一个独立的摄影师，也不是在工作室工作吗？	是的，我是在影楼工作的	0
你最喜欢什么类型的电影？	都喜欢，不分类型!	0
我之前也试着种过花，可是最后都没活下来，你是有什么门路吗？	我也不晓得啊!	0
我听说程序员会掉头发。你的头发怎么样？	我头发挺好的啊!	0
广州的语言是什么？	粤语，普通话，客家话，闽南语	0
你好，你是哪儿人氏？	我是陕西的,你好	0
我看你全身上下都是红色的，头发都是红色的，你很讨厌红色吗？	我喜欢蓝色系,红色系,绿色系	0
那你最喜欢什么植物啊？	喜欢的有很多啊,你呢	0
对啊，但是我好像劳作的不是很开心，你是做什么的呀？	我是做平面设计的。	0
你什么时候休息？	我明天上午休息，下午上班!	0
网友，你现在方便跟我谈谈吗？	可以呀,你说吧	0
你不和你父母一起去吗？	我父母不一定同意我自己去呢	0
你是运动员吗？	不是,我只是一个普通的学生	0
你坐了多久？	坐了一个小时，玩了四个小时!	0
巴耶来自哪个城市？	巴耶来自北京	0
哇，非常强大。那你一定很文学。你写小说多久了？	我是理科生,文笔也很一般,写的都是自己的感受	0
一年级学生的平均人数是多少？	不到一千人	0
你知道他读什么书吗？	我想我猜到了,他读的应该是小说书吧	0
你什么时候结婚的？	我还没结呢,哈哈	0
你是哪里人？	我是山东人，在青岛上学!	0
对呢	那很好呀,你现在是在哪里工作啊?	0
你知道我什么时候记忆力好吗？	不知道哎,你说嘛	0
嗯？	我做的是贷款,你呢?	0
那很好。你没有方向吗？	有啊，只是不知道能做什么	0
负责调查的人叫什么名字？	我叫李倩倩，这个名字很特别吧？	0
你还喜欢看卡通片呀？	是啊，我还喜欢小丸子呢	0
你多大了？	我20岁,我也在找工作	0
早上好你要去哪里？	我要去找我的女朋友!	0
你喜欢文学吗？	喜欢啊，我特别喜欢看推理小说	0
嗯，因为生活是多彩多样的，你厌烦医生这个职业吗？	不厌烦，只是不喜欢。	0
那个叫小英的人叫什么名字？	我不知道啊!	0
是的，我认为努力工作一定会有回报的。你刚下班吗？	嗯,我下班了,你呢?还没睡?	0
哇哦	不过你这么漂亮,估计追你的人很多吧	0
你不知道吗，那你平时讨厌玩什么啊？	我讨厌玩游戏啊，我喜欢看电影!	0
嘿，嘿，我为我说的话感到抱歉。该吃晚饭了。你还没吃东西吗？	没关系啦,现在吃啦,晚饭就不吃了,吃水果	0
哪里天气好？	哪里都很好,不冷不热,很舒服	0
你藏了一首谁的歌？	我是陈奕迅的歌迷,我没有藏歌,我想听他的歌,你唱给我嘛	0
喏	看你这么可爱我都舍不得欺负你了呢	0
哦哦，那你讨厌什么颜色？	不讨厌颜色	0
家里有多少男孩？	不多，只有一个女儿。	0
你什么时候没有计划？	今天没有，明天有，后天有，大后天也有!	0
我家有几条狗？	两条,一条萨摩一条金毛	0
我来自哪个省？	我猜你是山东的	0
谁是吉他手？	贝斯手和吉他手是谁?	0
我现在最大的爱好就是摄影和徒步旅行，你厌烦吗？	当然不会,喜欢的东西怎么会厌烦	0
你读过的书中有哪一本？	活着》和《追风筝的人》	0
你知道我最喜欢的乐队是什么吗？	不知道，你说说看。	0
上帝，我真的祝福你。你很开心吗？	开心啊,你真是太懂我了	0
你好，丫头，你在织毛衣吗？	我织的是围巾!不是毛衣!	0
你知道谁是一个非常好的歌手吗？	不知道，我只知道周杰伦!	1
你还是学生吗？	我当然还是学生啦,我还是一名大四学生	0
你什么时候发烧的？	前天晚上，昨晚上就开始了。	1
你知道我在哪家公司工作吗？	不知道!	0
我能带他们到我家住一会儿吗？	你家在哪里?我看看远不	0
你很喜欢军队吗？	是的，我很喜欢	0
你知道我多大了吗？	不知道，你告诉我吧	0
为什么要和老板一起吃饭？	因为他请我和我的朋友吃饭,他想认识更多人	0
下班后你最不喜欢做什么？	不喜欢睡觉，也不喜欢吃东西	0
他们觉得你怎么样？	他们觉得我太好面子,太好说话,太善良	0
你最喜欢哪个国家的女歌手？	艾薇儿不是美国的吗?还有泰勒斯威夫特,还有霉霉	0
你知道我不喜欢什么吗？	不知道呀,你说	0
所以你从小就住在青岛，不是吗？你现在在青岛工作吗？	没有工作,一直在家里	0
呐	那你平时都是吃些什么	0
你有好的地区推荐吗？	我也不知道，我也是刚来北京	0
你工作不忙吗？	不太忙,但是每天都有事情	0
你知道这葡萄有几种口味吗？	我都是在网上买,就见过一种,其他的没见过	0
那你在这家公司劳作多长时间了？	一年多吧，我也不知道!	0
对啊呀	你也喜欢吗？	0
？？？	你说的那句话我都没明白呢?	0
你知道我爱上了哪个队吗？	我不知道啊,我只是知道我喜欢这个队	0
嗨嗨嗨	嗨嗨嗨，你在干嘛呢？	0
你要回家吗？	我也没想好,可能过完年回去	0
那你有什么值得推荐的减肥措施吗？	我现在在吃一种瘦身果冻,我觉得还不错	0
我叫刘明，你现在是上学还是放工呢？	放工是什么,我不懂	0
你也讨厌花花吗？	哈哈,是的,我喜欢花花,也讨厌他	1
你最近看的电影是什么？	最近没看电影，最近在看电视剧	0
你好，你不玩博客吗？	玩博客,有什么事吗?	0
像你这样的普通人如此自由？	我是普通人，可是我有一颗自由的心!	0
你今年几岁？	我比你大，我是89年的!	0
那你有最讨厌的书吗？	没有，只有讨厌的人。	0
~~	那你是做什么工作的?	0
你知道我练空手道花了多长时间吗？	那你练了多久?	0
你喜欢在一天中的什么时候散步？	晚上，最好是清晨。	0
你养了多少条狗？	一只,死了后我就发誓不在养了	0
许多工厂外包给谁？	自己百度,多说没意义,我只想说,我就是做这行的	0
这对夫妇的女儿多大了？	他们的女儿快上小学了	0
就这个原故吗？	当然!还有更多的!	1
我也为你感到高兴。你将来会当公安吗？	会的，谢谢你的支持!	0
嗯对	那你有什么想说的吗？	0
这对夫妇养育了多少孩子？	不知道,但是有一个孩子夭折啦	0
你工作的公司叫什么名字？	在福田哪呢?我就在福田	0
好的，你刚才在看什么体育比赛？	我在看足球比赛，你呢？	0
嘿嘿对	你喜欢听谁的歌？	0
你什么时候回来？	后天下午吧，我现在还在车上呢!	0
很抱歉这么说。让我们谈谈你。你今天为什么不休息？	因为我有事情要做啊!	0
哟呵	哟呵啥子	0
你知道我多大了吗？	不知道,我只知道跟妈妈住很好	0
好的，那你的工作闲吗？	还好啦,不是很忙	0
真好，你都去哪里当过献血者呀？	北京献过,武汉也献过	0
真正地你对历史了解很多吗？	我只了解我所知道的。	0
你的大学入学考试怎么样？你不能进入你最喜欢的大学吗？	还没考,我现在还在纠结	0
周星驰的助手是谁？	好像说有两个,其中一个我也忘了是谁啦	0
你知道我多大了吗？	你不说,我怎么知道	0
什么的职员？	文员，文案，都是我的工作。	0
你知道我叫什么名字吗？	我知道你叫小猪	0
是呀，对了，你是做什么劳作的呢？	我是人事部门的	0
嘤嘤嘤	你喜欢吃什么我给你买	0
那你的日子都去做什么了呀？	就是吃饭睡觉打豆豆	0
哇呜	哇呜啥?你回家?	0
那你厌恶看什么类型的节目呢？	我不喜欢看综艺节目，我喜欢听音乐。	0
一个月赚多少钱？	那也不少呀,怎么做的呀?	0
回去需要几个月？	你回去需要几天?	0
你经常做志愿者吗？	不,我现在没时间	0
你什么时候去上班？	现在就在上班了，你呢？	0
你知道我去了哪个城市吗？	不知道。	0
噢	你什么时候上班呀?	0
到了吗？	到了哦,我做了一个多月了,现在都一钻了	0
那你除了厌烦听音乐还厌烦什么呢？	不喜欢人多的地方	0
对吧	好吧,我也学设计的	0
~	我是打算换个工作,但是还没有想好做什么	0
好啊	那你教教我呗,我也想试试,你能给我扣吗?	0
姐姐，你工作的薪水是多少？	这个不知道，我也不知道。	0
你知道我每年要留出多少天去旅行吗？	不知道。	0
嘿嘿对	我学的是汽车技术服务与营销,你呢?	0
那你呢？你通常不喜欢做什么？	不喜欢在家玩手机	0
你有几个孩子？	两个，一个男孩，一个女孩。	0
你知道我不喜欢什么吗？	不知道,我觉得沙拉很好吃啊	0
我的班级是几年级？	你是哪个学校的老师？	0
你不打算自己学习吗？	不打算，我只是想找个人一起学习	0
你喜欢她吗？	不喜欢我还这么纠结啊?	0
哈哈	我也不想工作啊,没办法	0
你是社会工作者吗？	我是刚毕业的大学生	0
但这很危险。你不怕骑马到河里去吗？	你说的是在什么地方遇到这种情况?	0
呦	你也喜欢看吗？	0
你读了多少本书？	我读的不多,我只是看过	1
没错没错，那你有自己的劳作吗？	有啊，每天都在做啊!	0
你不玩什么游戏？	以前玩,后来不玩了	0
是的，你最好找一份熟悉的工作。你是做什么的？	我是做平面设计的，呵呵!	0
当然，我会的。顺便问一下，你是做什么的？	我是做汽车行业的，有什么可以帮你的吗？	0
中国的首都是哪个城市？	北京,北京	0
你大部分时间想去做什么？	我想去云南旅游，看看那里的风景。	0
你知道和我在一起的人的年龄范围是多少吗？	不知道，我也不知道。	0
你知道我几岁开始演戏吗？	你说十岁,你十年前在哪里演?	0
你也喜欢听音乐。你不喜欢哪种音乐？	我不喜欢古典乐，我喜欢纯音乐。	0
可以啊	你平时喜欢什么样的运动？	0
你知道我讨厌什么季节吗？	讨厌夏天?	0
我觉得你很好。顺便问一下，你是做什么的？	我是做平面设计的。	0
这首歌是谁写的“这首歌叫什么名字？”？	这是驹哥写的,叫风继续吹	0
你不会还在放工吧？	没有,我早就到家了	0
你知道我一周在剧院演出几次吗？	一周三次吗,在哪个剧院	0
装修你的房子要花多少钱？	不知道呢,估计十万以上吧,还得买家具电器什么的	0
你知道我喜欢什么时候喝啤酒吗？	不懂,你说来听听	0
诶呀	你是哪里人啊？	0
你知道我每天跑多少米吗？	不知道,不过1000米也不算多	1
商店里有什么食物？	什么商店?	0
你现在还能写字吗？	能的,只是没以前那么好看了	0
是的，你会打篮球吗？	篮球会一点点,不多	0
你知道它已经流行了多少年了吗？	我不知道,我只知道我喜欢看它	0
那你除了劳作的话，平常闲空的时候喜欢什么呀？	看小说,听歌,打游戏,逛街,吃东西,等等	0
那时候你玩什么游戏？	英雄联盟，三国杀，王者荣耀，lol	0
嘿，你也睡不好。你还在康复吗？	是啊，还在治疗中。	0
你知道菊花在什么季节开放吗？	我不知道耶,我知道秋天是菊花开的季节,还有,你怎么还没睡	1
那你一定不在学校了？	在呀,我大四呢,还有两年才毕业	0
也许吧。你工作累了吗？	还好，习惯了!	0
呦呦呦	我不信,你会有工作介绍给我	0
和我一样的人在哪里结婚的？	在韩国啊，你也喜欢他吗？	0
你什么时候骑马？	明天早上，你在哪儿？	0
还是你更有洞察力？你是做什么的？	我就是一个普通的职员,你在哪儿上班呢?	0
你知道我男朋友什么时候去看我最喜欢的艺术展的吗？	我不知道，你告诉我吧!	0
你知道我是哪里人吗？	不知道,河南的吗	0
你知道我休息几天吗？	不知道!我又不认识你	0
好吧，你是做什么的？	我是做互联网金融的，你也是吗？	0
那你会经常来野外采风吗？	不会,我在家附近的公园里	0
你是哪个班的学生？	我不是这个学校的,我是别的学校的	0
你一个月只休息两天。你不累吗？	不累,因为没人给我发工资	0
你知道我每天跑多少米吗？	难道是传说中的5000米	0
你什么时候发烧的？	昨天下午，一直到今天早上都在发烧。	0
你知道我在一周的哪一天看足球吗？	不知道!	0
餐厅在哪里？	上海虹口区，徐汇区。	0
你是在上学还是在放工啊？	上学和放工有何区别	0
呦呦呦	真的啊,我在这边找了一个工作	0
你知道我喜欢谁的歌吗？	不知道啊，我只知道你喜欢毛不易	0
你好，我住在北京。你呢？	我在昌平区，离北京挺远的!	1
你通常有什么特别的爱好吗？	我喜欢睡觉，睡觉是最好的运动。	0
你知道我什么时候和朋友去滑板吗？	不知道!但是我知道你喜欢!	0
你是哪里人？	我是东北的，在湖南上学!	0
你要回学校多少天？	不知道呢,还没定呢	0
我没有午睡的习惯，你是一个厌恶午睡的人？	我只是讨厌吵醒我,我喜欢安静	0
你知道我去哪里观光吗？	不知道!	0
你刚到哪个城市？	北京，你在哪儿呢？	0
看来女儿都是这样呀，你是做什么的？	我是卖衣衣的,嘿嘿	0
顺便问一下，你从哪里来的？	我从湖北来的	0
是的，这将是一个假期，但是你为什么喜欢国庆节呢？	因为国庆节可以放假	0
。。。	那你的目标是什么呀?	0
脑门，你说的好像还是蛮有理的，那你现在是做什么的呢？	我现在在一家小小的小公司上班。	0
你好，你不玩博客吗？	我想邀请你加入我们博客,可以吗?	0
你多大了？	我22岁了，你呢？	0
咳	我是说真的,别不相信啊	0
你现在住在哪里？你的家乡在哪里？	我在深圳，我的家在广州。	0
我叫李海。你叫什么名字？	我叫张一帆，你呢!	0
！！！	你是谁啊？	0
你知道我多大的时候开始跳舞吗？	我知道你从小就很爱跳舞我也很羡慕会跳舞的人	0
呦呦呦	呦呦呦,我是在问你,想给我介绍工作,还是什么	0
这首歌代表了你的心？	我的心是一首歌，它代表了我的心!	0
我现在是一家超市的总经理。你有什么爱好吗？	我喜欢旅游，喜欢摄影，喜欢旅行。	0
你不是很喜欢看新闻吗？	我只喜欢看娱乐新闻	0
你还没有当爹妈吗？	没有啊!我还小呢!	0
你通常不喜欢去哪里？	不喜欢呆在家	0
哦这样啊，那个我喜欢烹饪，你讨厌干什么啊？	讨厌做菜，讨厌洗碗，讨厌刷碗!	0
你一个月能挣多少元？	我呀,我一个月能赚3多,够花了	0
你知道我最喜欢的炖茄子是什么时候做的吗？	不知道!	0
你知道我是哪里人吗？	你不是要在北京买房吗,难道不是北京人?	0
学生在哪里？	就在本部啊	0
你不拍什么样的照片？	不拍,拍的不好	0
负责调查的人叫什么名字？	我叫李佳芝，你叫我琪琪就可以了。	0
是的，那你是做什么劳作呀？	我在做行政文员	0
你知道孩子五岁是哪一年吗？	不知道,你告诉我呗	0
嗨，你是什么劳作的啊？	我是做金融的	0
你假期喜欢做什么？	我喜欢一个人出去旅行，一个人呆着	0
有多少年了？	两年多，断断续续的。	0
你知道我每天什么时候跑步吗？	不造,反正我不在	0
你无聊的时候都会做些什么来打发日子？	看书看电影看小说看电视	0
经理是哪个部门的？	你问这个做什么？	0
……	那你现在是在工作,还是在上学呀	0
你平时吃完饭就在家做事吗？	是啊，不过我都是在家做的。	0
你一个月挣多少元？	4千多,够自己花就行了,嘿嘿	0
你是去体操房吗？	对啊，我在体适美，你呢？	1
非常感谢。将来我能经常和你一起学习吗？	以后有什么事可以直接找我啊,只要我在就一定帮你	0
我30岁了。你不是高中生吗？	我是说我还没上大学呢!	0
你知道我需要多少年才能退休吗？	我是助理,不需要考,但如果你想做这个,可以考	0
没关系。你喜欢画什么？	我画的都是很简单的	0
啊啊	你说我该怎么办,我真的好喜欢他,好纠结	0
你知道现在是几月吗？	三月吧,难道不是吗	0
你知道我在一周的哪一天看足球吗？	不知道!	0
你知道我跑几次马拉松吗？	不知道,你在哪里跑	0
当然你现在不忙吗？	我在公司啊,刚下班	0
那你这些天都不能上班了，是吗？	是的，这个月都不行了。	0
你每晚什么时候跑步？	七点多吧,你呢	0
嗯，我相信我们会成为非常要好的友人，我们下次的聊天会更加愉快，你说呢？	我说我不造	0
你在哪里工作？	我在闵行上班	0
我是会计。你去上班了吗？	我还没呢，你是做什么的？	0
我什么时候上二年级？	我也不知道,我都没上过	0
你是哪里人？	我在广州的,不过也会去深圳那边实习,我是湖南的	0
翻译这么好的劳作，你竟然丢了？	这是个悲伤的故事,请不要再问了	0
你加入了很多。你不忙吗？	我都退了,不忙啊,因为我是学渣	0
你知道我多大了吗？	你不是说12吗	0
我多大的时候开始学习音乐？	我也不知道，大概四五岁吧。	1
你知道谁是我最喜欢的艺术家吗？	是不是杨丽萍老师	0
你是哪里人？	我是地球人啊,你是来自星星的吗	0
一年中最喜庆的日子是什么？	春节是一个特殊的日子。	0
你厌烦什么音乐呢？	没有特定的,都喜欢	0
你学的是什么专业？	管理科学与工程，你呢？	0
哦哦对	你是做什么工作的？	0
你不推荐什么？	你预算太少了啊	0
好	你在哪个城市？	0
没有，我和爹妈住在一起，你是学什么专业的啊？	我学的建筑工程管理，你呢	0
我多大了？	你妈和你住一起,你不是30么?	0
我不喜欢唱歌，但我喜欢听歌曲。你在唱谁的歌？	我在唱我自己的歌。	0
那你这些天都不能上班了，是吗？	是的，所以我要辞了。	0
有一个宝贝，你今天没有放工吗？	没有啊,我们不放工	0
你知道你多大了吗？	不知道,不过,我觉得我还年轻	0
你靠写故事谋生吗？	你写故事是为了谋生?	0
我20岁是什么时候？	你自己说的你今年20岁啊	0
你弹吉他有多少年了？	小学开始,现在大四了	0
你知道我多大了吗？	不知道，我只知道你比我大。	0
哦哦，那你一天劳作多长时间呢？	不到1个小时	0
我喜欢踢毽子。你呢？	我喜欢你!	0
你知道我多大了吗？	不知道啊，我还没结婚呢	0
你的车叫什么名字？	捷安特xt4	0
哼	哈哈!不跟你闹了,其实你比我大	0
怎么了你不是做了你喜欢做的吗？	没有,一直没有工作	0
唉	别叹气了，你也会有猫的!	0
咳	这是什么意思,我真的怕,小时候被虫子咬过,有心理阴影	0
你没有作业要做吗？	有啊,我在做呢	0
你有几个孩子？	一个，他们都是我的孩子。	1
你要去哪里？	去西藏啊	0
我有几个女儿？	我知道,有俩个	0
你知道谁是公主吗？	不知道，我只知道她是公主。	1
哈哈	我现在也不想找对象,但是我想结婚,我想有个家	0
我是个女孩。你现在在做什么？	我是女孩,我现在在上班	0
当然你今年几岁？	我今年22岁了，我想知道你的年龄。	0
IT男呀，那你平常的劳作是不是很辛苦呀？	不算辛苦,你呢	0
你多大了？	我今年24岁了，有什么事吗？	0
好的，你现在是在上学还是已经劳作了？	我在上学，还没毕业呢!	0
我最近需要买一双运动鞋跑步。你有什么好牌子的鞋子可以推荐吗？	我也不知道，我都是在网上买的	0
你知道我什么时候睡觉吗？	我怎么可能知道,我又不关心你	0
他有几个女儿？	他有三个女儿，一个儿子，一个女儿!	1
职业球员，有这样的职业吗？	有的，只是你不知道而已!	0
你女儿现在不是在找工作吗？	是啊,但是我女儿是自己找到工作的	1
你是做什么工作的？	我是做室内设计的。	0
呦呵	呦呵?你找到合适的了?	0
你要去哪里划船？	不知道呢,还没想好	0
你是哪里人？	我是河北人，现在在北京工作!	0
啊	留胡子显成熟	0
没事的，你现在是已经劳作了还是在上学呢？	还在上学，不过快毕业了!	0
听你的意思，你不是一直在河南吧？	不是啊,今年回来了	0
你呢，也很忙吗？	是啊!忙的时候忙死，闲的时候闲死!	0
我13岁是什么时候？	你不是已经成年了吗？	0
是不是你回的地方鱼比较老啊？	这个我就不知道了!	0
是的，有吗？	有啊，你在干嘛呢？	0
你最喜欢哪个都市旅行呢？	有海,有山,有水,有花,有草,有吃的,就行	0
你知道我喜欢听什么吗？	喜欢听老歌	0
你是哪里人？	我是河北人，现在在北京工作!	0
你知道我男朋友是哪里人吗？	不知道，你告诉我吧	0
你在哪里学习？	哦,我在湖南	0
你知道我最喜欢的乐队是什么吗？	不知道,我是在微信公众号上买的	0
咖啡店在哪里？	就在我家附近，你要来吗？	0
你在学校时喜欢谁？	五月天，五月天	0
请问你有厌恶的音乐吗？	没有，我不喜欢摇滚，也不喜欢摇滚乐	0
我很羡慕你，你厌烦听歌吗？	不厌烦,我很喜欢	0
噢噢	你是女生呀?	0
这也很好。你在家做什么？	这也蛮好的,你在家做什么?	0
它被播放了多少次？	好像是10多次吧,记不清了	0
你知道自由狮身人面像吗？	不知道	0
你知道我喜欢听什么书吗？	不知道,你给我推荐推荐吧	0
这么早就看小说，你不去上班或上学吗？	上班的，只是偶尔会看小说。	0
这只小鸟多大了？	大概2岁多吧!	0
你们酒吧的环境怎么样？很乱吗？	还行吧，也不是很乱。	0
哦对了	嗯,祝你生活愉快	0
你还是学生吗？	对啊，我是学生啊，你呢？	0
小李是什么样的人？	他是个悲剧角色,他喜欢的女生不喜欢他,最后自杀了	0
我喜欢谁？	你喜欢谁不重要，重要的是我喜欢你!	0
是的，我经常在业余时间去健身房。健身真的让人上瘾。你不相信吗？	信啊!怎么不信啊	0
火锅里你最厌恶什么呀？	不喜欢吃火锅里的任何东西!	0
我在一家保险公司工作。你呢？	我在平安保险，人寿保险。	0
你不是很喜欢跳舞吗？	喜欢但是不会跳	0
嗯嗯	你在哪上大学啊?	0
但我的方式不太适合你吗？	你的方式是什么样的？	0
你知道我什么时候起床喂鸟，听鸟叫吗？	我不知道,我只知道我现在每天早上都有鸟叫,我要起床了	0
你父母是怎么教你这么好的？	我父母对我也很好啊!	0
！	看书,听歌,看电影,睡觉	0
姐儿你好，在干嘛？	姐妹,我在看你	0
学做饭很好。那你一定会做很多菜，是吗？	会啊,我做的饭我自己都不爱吃	0
我什么时候看电视新闻？	你看电视的时候，我在看电视。	0
嘻哈	我也喜欢听嘻哈!	0
你多大了？	我比你大四岁,是不是老了	0
你知道高考后我现在去哪里吗？	不知道去哪?	0
你能演奏什么乐器？	吉他，吉他是我唯一会的乐器	0
你没有什么爱好吗？	没有，我也不知道自己喜欢什么	0
好吧，那你现在是做什么劳作的呢？	我现在在一家公司做销售，还在试用期。	0
你知道我喜欢哪个韩国歌手吗？	不知道	0
你是一个学生吗？	不是，我只是来找我的朋友的!	0
嗨	你是不是在家呆的很无聊啊	0
你知道我最喜欢的电影是什么吗？	我不知道，你告诉我吧!	0
你知道我来自哪个部门吗？	不知道呀,难道是办公室的?	0
你知道我开始练习的时候多大了吗？	不到十岁	0
你怎么了？你现在不是有自己的房子吗？	我现在没有房子，只有一间空房子。	1
小雨是哪一年？	90年的，你呢	0
毕竟缘这个东西很不可描述的，那你是做什么劳作的呀？	我是做工程的，你呢？	0
我在哪里工作？	横店在浙江金华	0
你知道711的号码是多少吗？	我不知道,我只在超市买过东西	0
是的，你不是每天都忙着工作吗？	嗯,忙里偷闲	0
你知道我多大了吗？	不知道!	0
对对对	我养了一只小金毛呢	0
你现在还在和你妈妈做手工艺品吗？	我妈妈做,我做不了,我没有时间	0
啊哦	你在干嘛呢？	0
你多大了？	我是88年的。	0
呗	你喜欢什么样的聊天方式？	0
你吃过了吗？	还没吃,我还饿着呢	0
谁拍的这部电影？	好像是韩国的一个,名字忘了	0
你知道现在谁是新手吗？	不知道啊!	0
哇哇哇	你是东北哪里人?	0
那好吧，那你有什么讨厌的呢？	我讨厌的?讨厌的人吗?	0
我要去什么样的地方？	你想去什么地方呢？	0
在家购物要多少钱？	不用花钱,有手机就可以了	0
你叫什么名字？	我叫王玉清，请问你是谁？	0
看来你还是学员吧？	我也工作了,我在北京,你呢?	0
你现在和你女儿单独在一起？	是的，她们两个在一起。	0
听你的意思，你不是一直在河南吧？	是的,以前在北京呆过四年,去年刚回来	0
这对夫妇有几个孩子？	一个,我和她是第一对,我是她第二对,她是我第三对	1
你穿的衣服真可爱。是动画中的形状吗？	是的，就是动画片里的衣服!	0
星期几？	星期六,你来了?	0
哦	你下班好晚	0
你学的是什么专业？	我学的是汉语言文学，你呢？	0
是的，你想跟我谈什么？	我想跟你谈的可多了呢	0
我真的在找一个男孩聊天。我还在上大学。你工作过吗？	没有，我也在找人聊天。	0
哟	咋啦,猫多可爱啊	0
有多少只仓鼠？	现在是三只	0
你知道你多大了吗？	我不知道，我只知道我已经老了!	0
你小时候学的吗？	我是大学才开始学的	0
你最厌恶的电影是什么？	我最讨厌的电影太多了!	0
你上的课叫什么名字？	我上的是国际经济与贸易	0
你就读的学校叫什么名字？	不好意思,这个我就不说了	0
哦哦，那你是住在校园还是住在家里啊？	我是住校的,你呢?	0
你知道我找到工作时多大年纪吗？	不知道，我只知道你现在还在读书。	0
嗨	姐姐做网店的吗我想跟你学学可以吗?真心求教	0
你什么时候去上班的？	今天上午去的，下午就回来了!	0
一个月15000英镑足够养活自己了。那你呢？你有工作吗？	我在找工作，不知道什么时候能找到。	0
你的薪水也很高。你是做什么的？	我的工作很辛苦的,我在做销售呢	0
你不想和解吗？	你可以试着和她们谈谈,你的问题,他们都知道?他们会支持你吗?	0
你一月份挣了多少钱？	一个亿都有可能啊	0
我的猜测仍然相当准确。你们学校允许染头发吗？	不允许,但是你可以染,但是要注意不要被抓住,不然后果很严重	0
你好，请问你穿西装干什么？	工作服啊，还能干什么!	0
你是哪里人？	我是上海人，现在在上海工作!	0
是在课外班玩耍的吗？	是的，欢迎你来!	0
呃呃	我也是啊,你几岁了?	0
你是画家吗？	我还没到能画出这种水平来的地步,不过我会努力的	0
嗯好的，你们常来敬老院的吗？	没去过哦,你是去看望老人的啊?	0
你在读哪所大学？	你是黄冈哪里的	0
好吧，你有听过好妹妹乐队的歌曲吗？	没有，不知道你说的是哪个乐队	0
你会做衣服吗？	我会做,我是裁缝	0
我有时间和你一起学习怎么样？	可以啊!你是什么专业的？	0
呦	怎么了,有什么好的建议吗	0
那个问你一个问题，一见钟情，你相信吗？	那个,说实话我不相信	0
你知道我喜欢什么样的天气吗？	我不知道,你告诉我吧	0
你什么时候下班？	下周二，你呢？	0
我13岁是什么时候？	不知道啊!你几岁啊？	0
商队有多少钱？	商队?	0
你知道程序员的智商是多少吗？	不知道,但是你不是250	0
你工作了多少年了？	我已经在这里工作了三年多了。	0
你是做什么的？	我是做室内设计的。	0
我出去的时候多大了？	我觉得你应该是16岁出去的吧!你是高中毕业去的日本?	0
我对目前的工作也很满意。你是做什么的？	我是做财务的，你在哪个城市？	0
你训练的目的是什么？	为了让你开心呀!	0
有多少段？	我也不知道，我也是二段的	0
你所在的班级叫什么名字？	我在河南焦作	0
你去大医院了吗？	没有，不知道在哪!	0
哦，你们卖什么样的车？	什么车型都有	0
你是哪所学校的？	我是河北工业大学的，现在在北京上学。	0
正在看这个节目的年轻人叫谁？	不知道,我都不知道我在看什么	0
我在哪里负责软件？	程序员的工作就是和程序员打交道。	0
你什么时候毕业的？	我今年刚毕业,我是去年12月份参加的考试,考上的	0
那确实太让人难过了，你现在上学还是放工呢？	你也在上学啊,你上大几啊?	0
你知道谁是最受欢迎的现代流行歌曲吗？	不知道,你知道吗?	0
唉	你是卖果冻的	0
哟呵	这是我小时候的生活	0
你痊愈了吗？	痊愈了，已经痊愈了	0
是的，你今年多大了？	我已经25岁了，呵呵!	0
你知道下班后我会和朋友一起打篮球吗吗？	我是98年1月的,你呢	0
你知道我20岁是什么时候吗？	你不是说20岁吗	0
太好了。你毕业后不是在找生物学的工作吗？	是的，不过我还没毕业。	0
嘻	所以你有参加过吗?	0
看来你还是个旅游爱好者。你去过哪里？	我去过很多地方，还有一些地方没去过。	0
是嘛，那你劳作是啥啊？	我劳作的话，应该是搬砖吧!	0
你知道我什么时候请假的吗？	你说请假了,我以为是今天请假	0
你有多高？	我不高，也不矮，只是个子不高。	1
对哦	那你工作了几年?	0
你知道我多大了吗？	不知道，你是男生还是女生？	0
店里有多少人？	不知道，反正就我和妈两个	1
那你呢？你通常不喜欢做什么？	没什么喜欢不喜欢的,只是不喜欢一个人的时候	0
你多大了？	我今年刚满十八岁!	0
你什么时候下班？	我已经下班了，现在在回家的路上!	0
你在哪里长大的？	我在北京出生，现在在北京工作!	0
我来自哪个城市？	河北邯郸，你是河北哪儿的？	1
你好，你忙吗？你有时间聊天吗？	我有时间,你在哪	0
这个人的名字是什么？	我也不知道，我只知道他叫周杰伦	1
你儿子在哪里？	我儿子不知道在哪呢!	0
你学什么语言？	法语，西语，韩语，法语，德语。	0
你好，你还没休息吗？	你好,我准备睡觉了,你早点休息吧	0
我是学音乐专业的，你也是个学习者吗？	我是学美术的,你也是个学习者吗?	0
你知道我通常什么时候起床锻炼吗？	不知道,我猜是六点左右	0
我认为宠物狗很好。他们也可以和你一起玩。当你无聊的时候你会做什么？	睡觉，看书，看电影，打豆豆。	0
那你应该快跑？	我跑的挺快的	0
我叫王兵。嘿，你吃晚饭了吗？	我吃了，你要吃什么？	0
是的，我是一名职员。你忙吗？	你不说我还没发现是你在找对象啊	0
不，太可怕了。我更喜欢看一些青年校园的节目。你不喜欢吗？	我不看综艺节目,只看电影电视剧	0
他在哪里？	他在南通	0
约会是星期几？	星期六，你想去哪儿？	0
和你在一起的人的年龄是多少？	20岁，25岁，50岁，40岁.	0
你讨厌什么乐器呀？	没有讨厌的,也没有喜欢的	0
你早上什么时候跑步，什么时候？	6点多,7点	0
我最喜欢的乐队是什么？	我也不知道，就是喜欢!	0
顺便说一下，我忘了问你。你学习怎么样？	学渣,学渣,学渣	0
你知道我是哪里人吗？	不知道,我只知道你叫张佳	0
嘁	我做的是一家互联网公司,你也是做销售的吗?	0
你是演员吗？	我是演员,怎么了?	0
我出去的时候多大了？	我不知道,我觉得我还挺小的	0
你的家在哪里？	我的家就在北京啊。	0
你是哪里人？	我是河北人，现在在北京工作!	0
我最喜欢的乐队是844乐队。你听不见吗？	听的见啊	0
挺不错的，那你出门会不会被人物认出来啊？	不会啊，我又不认识他们!	0
你真幽默。你住在哪里？	你隔壁,姓王的	0
你小时候学的吗？	是啊,现在都高二了,才学一年	1
那么你的身体状况很好？	还好，只是有些累而已。	0
真好，你都去哪里当过献血者呀？	在哪里都没去过,就去医院献过血	1
你知道我有几个兄弟吗？	我知道你有几个姐姐	0
你好，你的口音听起来有点像上海话。你是上海人吗？	不是啦,只是在上海生活的很习惯,所以有点上海腔	0
挺不错的，那你出门会不会被人物认出来啊？	不会的!我很低调的!	0
这个周末你要上班吗？	是啊,这周都要	0
你多大了？	你比我大,我90年的	0
你知道我是哪里人吗？	不知道，我在上海郊区，你呢？	0
你知道我跑几次马拉松吗？	我知道啊，你跑了多少次了？	1
你为什么不伤心？	伤心啊,怎么会不伤心	0
我在运动。我喜欢运动。你喜欢吗？	喜欢，我也喜欢!	0
啊	我是说真的呀,我最近倒霉透顶啦	0
法拉利是我最喜欢的车。你能帮我拍照吗？	拍了,在楼下	0
难道你就没有那种想看很多遍的影片吗？	有啊，可是我不喜欢看电影。	1
你看了什么电视剧？	我在看湖南卫视的一个节目，叫我爱上一个人	0
你是怎么学习的？	我是英语专业的，英语老师教的挺好的!	0
负责人负责人负责人负责人负责人负责人	那你现在在哪儿呢？	0
你好，你有什么爱好？	我也喜欢打游戏,不过打得不好	0
对唉	我用电脑看直播	0
你知道我多大了吗？	你不是说你16吗,我也16啊	0
你是哪里人？	你是广州哪的?	0
你会游泳吗？	废话啊,我当然会了	0
你知道我是哪个队的运动员吗？	我还真不知道,你告诉我呗	0
你多大了？	比我小,叫姐姐	0
…	你是男的还是女的？	0
是的，我在金融行业工作。我每天很早就去上班。你不去上班吗？	我还没找到合适的工作呢!	0
我也刚吃过，你早餐吃的什么呀？	我在外面吃的	0
你应该年轻，不是吗？	我已经过了青春的年龄了!	0
那你喜欢箜篌吗？	不喜欢，我喜欢弹琴的人!	0
你一定很年轻吧？	还好,比你大两岁	0
嗨喽呀	我是说你现在还在上班么?还是在带孩子了呢?	0
你为哪些人工作？	我为自己工作，也为别人工作!	0
你从哪一年开始？	12年吧，好像是。	0
你父母不知道吗？	不知道，他们也不知道	0
我是黑带。你想和我竞争吗？	你是黑带？那我是什么呢？	0
你知道我喜欢谁的歌吗？	不知道哎,你说来听听	0
你好你现在正在做什么？	我在等火车，马上就到了!	0
你对健身感兴趣吗？	我对健身不感兴趣，只是喜欢运动而已!	0
是啊，我还是学员呢，你在做什么劳作呢？	我在做财务方面的工作，你呢？	0
你知道我现在开的车是什么吗？	不知道，我只知道你开的是玛莎拉蒂	1
你写歌了吗？	没有，我只是写了一首歌而已!	1
你在哪里工作？	南京博物院啊	0
你读了多少本书？	很多,不过都没什么印象了	0
如果你需要，你可以。我请客。你有什么要求吗？	没有什么特别的要求，就是喜欢你!	0
除了听歌，你还喜欢什么？	我喜欢看动漫,我看你的头像就是,宫崎骏老爷子	0
你住在哪里？	我住在静安寺附近，你呢	0
哈哈	你现在在哪儿工作?	0
你知道我多大了吗？	难道你比我还大?我都60了,你还想比我大?	0
是的，我非常喜欢交朋友，所以我有很多朋友。你不喜欢交朋友吗？	不喜欢,我只喜欢女朋友	0
你一个月工资很高吗？	不高,但是比你高	0
嘿嘿，你有什么厌恶的吗？	我不喜欢太吵的,喜欢安静的地方	0
你假期有什么计划吗？	没有，我现在在上海，过几天去上海!	1
你知道我读的那本书叫什么名字吗？	不知道!	0
你是不是很讨厌旅游啊？	我也喜欢,可是我不太会,也不敢	0
我刚吃完饭，现在躺在床上。你在做什么？	躺着看电视呢,无聊啊,你呢	0
紫色会不会太炸眼呀，你爹妈愿意你染头发吗？	他们说我染什么都好看	0
你多大了？	比你大，比你年轻!	1
你通常什么时候做？	我一般是晚上7点到9点之间。	0
那你这样身子会很不舒服的呀，那么累工作量那么大，睡眠日子在一少，你身子吃得消吗？	我也不清楚，应该还好吧!	0
呃呃	真的,你看我微博	0
啊？	你不喜欢和人说话,怎么和人相处呢?	0
你知道我有几个孩子吗？	不知道啊,难道有三个?	0
是的，你刚从大学毕业吗？	不是,我刚大三,在郑州上学	0
哈哈	你应该比我小吧,哈哈,小鲜肉	0
除了晚上，你通常还有什么时间？	除了下午和晚上，其他时间都有时间。	0
是呀，那你有什么喜欢做的事吗？	我喜欢睡觉。	0
你经常来健身房吗？	不经常去,我一般自己在家练	0
嘛	你喜欢看什么书？	0
哪个季节太热？	现在就很热啊,你可以来我店看,你要有兴趣加我微信吧	0
你现在是已经上学了呢，还是在劳作？	我还在上学呢，不过也快毕业了!	0
哎呦	你是不是在书店工作啊？	0
我是一名退休的计算机程序员。你呢？	我是个学生，我也是一名程序员	0
你觉得情爱是什么？	爱情是两个人的事，一个人的事情。	1
你喜欢的社团叫什么名字？	没有社团	0
我最喜欢的乐队之一是什么？	五月天啊，五月天的歌都很好听!	0
嗯嗯，听你说的这么有道理，你是也厌恶读书吗？	不厌恶，只是不喜欢!	0
那你讨厌唱什么类型的歌呢？	什么都不讨厌	0
诶	你是喜欢吃零食呢,还是什么呢	0
你休息时做什么？	睡觉，上网，看电视，睡觉，玩手机	0
那你讨厌什么风格的衣服呢？	不讨厌，只是不喜欢。	0
诶呦	我也是诶,哈哈,好有缘分	0
你不是经常出去散步吗？	是啊，可是我不喜欢运动。	0
你从哪个方向来？	我从南边来，你呢？	0
你通常买什么书？	都是言情小说	0
这对你来说太难了吗？	对我来说很难，因为我是个话唠!	0
是的，我经常跑步。你有最喜欢的运动吗？	羽毛球啊,你经常去哪里打羽毛球啊	0
你知道我是哪个年级的学生吗？	不知道!	0
你知道我能说多少种语言吗？	不知道，你能说几个？	0
那你很孝顺。你为什么不考虑换个更近的工作呢？	我妈说换了工作我一个月就没工资了,现在工作不好找啊	0
哦哦嗯	你在读大学还是?	0
你知道我非常喜欢谁吗？	不知道!	0
那很好。这并不孤独。你是做什么的？	我是做汽车销售的!	0
生活是为了多少人？	为自己吧,自己开心快乐就好,别人爱谁谁	0
你为什么去上班？	因为我喜欢啊，我喜欢工作啊!	0
你好，你经常看书吗？	我很少看书，只是喜欢看而已!	0
我什么时候才是成年人？	你现在就已经是了!	0
喏	你在干什么？	0
真的吗，你最不喜欢的画是什么？	素描吧,最讨厌素描了,不过我还是画了	0
哇，这些动物很可爱，不是吗？但你住在哪里？	我在学校宿舍,宿舍不让养啊	0
那你一定很讨厌看书喽？	是的，非常讨厌!	0
嗯呢	唱首呗	0
这也很正常，喜欢戏法的确实比较少，那你今天过得怎么样呢？	挺好的啊,你呢?	0
很多人不经常去你的工作室录歌？	是的,不经常	0
哦你喜欢音乐呀，那你讨厌哪个歌手呀？	我不讨厌谁，只是不喜欢他们的歌	0
你在空闲的时候讨厌干什么呀？	没啥讨厌的	0
你知道我的身体有多高吗？	我不知道你的身高	0
清华大学在哪里？	在河北保定，离北京挺远的。	0
呗	转专业要什么要求吗?难吗?	0
我很喜欢周末去看电影，你厌烦看什么综艺？	我不看综艺	0
是呀，对了，你有没有喜欢的食品呀？	你是说零食么?	0
我妈妈什么时候不在家？	这个就不知道了!	0
那你平时厌恶干什么啊？	厌恶,没有,都可以接受	0
这是必要的。顺便问一下，你是做什么的？	我上班的啊没事自己在家做了一个小网,店,一个月也能挣个四五千块钱	0
哇啊	你不觉得我很可怜吗	0
好	你在北京哪儿呢？	0
你没吃午饭吗？	吃了,不饿,吃的少	0
你多大了？	我92年的，你应该比我大吧？	0
你知道我是哪里人吗？	知道啊,我看到了	0
然后呢	然后就没有然后了!	0
什么商店附近有什么？	好像有很多商店吧，我也不知道!	0
你不是太简单了吗？	简单不好么	0
你多久打一次电话？	有时候一个月一次,有时候一星期打一个	0
你知道我最喜欢的食物是什么吗？	不是汉堡就是炸鸡,你自己说的	0
您好，你觉得这个东方明珠怎么样？	还行吧!挺漂亮的!	0
我多大了？	你不是说你比我大吗？	0
你很喜欢山东菜。你是山东人吗？	山东济南历下区	0
你知道我的朋友们说东北地区通常在什么季节不冷吗？	我知道,我是东北人,但不是沈阳的	0
你知道我喜欢什么样的天气吗？	下雨?下雪?	0
买一辆车要多少钱？	你要买什么牌子的,什么类型的	0
嗯对	你是哪里的?多大?	0
你的工作薪水高吗？	不高，刚毕业的学生，没什么钱!	0
对啊呀	那你平时喜欢干嘛？	0
我在吃我最喜欢的寿司！你喜欢吃什么？	我喜欢寿司，可是我不知道怎么做!	0
喏	你不好我也不好	0
我是广州人士，你呢？	我也是,你是广州哪里的?	0
你们在一起有多少年了？	我也不知道，大概有八年了吧。	0
你知道我多大了吗？	不是23嘛,难道我记错了	0
顺便问一下，你现在做什么？	我现在做的是外贸业务员。	0
嗯嗯	大一的话还是挺轻松的,你是想学什么专业?	0
好吧，你不是老大哥吗？	你才是老大哥呢,我才大几岁	0
你喜欢瑜伽吗？	喜欢啊!	0
你不习惯在哪个国家吃饭？	中国的中餐,我都不吃	0
对唉	电视上能看,我看了	0
你一天中什么时候可以睡觉？	不知道啊，我也不知道	0
你开餐饮店一年大概可以赚多少钱啊？	我开的小饭店,生意不好做,一年赚不到二十万,还经常亏本	0
是呀，你有讨厌的女孩子吗？	没有,我觉得我是个好人,怎么会有人讨厌	0
你一点都不喜欢打台球吗？	喜欢啊，只是很久没有打了	0
你知道我家的语言是什么吗？	我只知道粤语和客家话	0
你知道我的孩子多大了吗？	不知道，我只知道你是我的妻子。	0
你所属的军队在哪里？	我在成都，你是哪个单位的？	0
你在一家小店一个月能挣多少钱？	不固定,好的的时候四五千,差的时候两三千	0
中国政府总部在哪里？	北京朝阳区望京路798号!	0
我拍了很多照片。你不想看吗？	想看!但是我要先看你的!	0
电影里是谁？	电影里的房思琪是个小女孩	0
我更喜欢看动画电影。你家在哪里？	我家在海淀，你呢	0
唔	好吧，那我就不客气了!	0
你平时厌烦干什么？	没有吧,我觉得我都可以	0
看来你需要克服很大的恐惧啊，那不会很凶险吗？	不知道，我也不知道怎么办	0
那你是不是要来实习啊？	我在上班了啊	0
嗨嗨嗨	嗨，你好，我是你的粉丝	0
你知道我喜欢在哪个国家听摇滚乐吗？	不晓得,你说说啊	0
你问我忙不忙，难道你的劳作很忙吗？	不忙了,现在就想找工作	0
那你没事干了？	是的,我现在就没啥事干	0
你有什么想做的吗？	我现在想找一份能让自己坚持下去的工作,但找不到	0
你知道我什么时候大学毕业的吗？	不知道。	0
他在哪里吃的？	我说他在中国吃过了	0
你开始学钢琴的第一个年级是什么时候？	小学六年级，应该是六年级吧。	0
大一是哪一年？	好吧,其实我是准大四	0
你有几个孩子？	两个孩子,都在我身边	0
可	那你是怎么做的呢?	0
你想去哪里？	想去天津,但是天津大学分太高了	0
你知道我多大了吗？	不知道呀,我猜是个孩子	0
我通常喜欢玩游戏。你还有其他爱好吗？	还有一个喜欢的爱好,那就是你	0
你知道玛丽的妹妹是谁吗？	马丽?	0
你喝了多少啤酒？	没喝酒，就喝了几口啤酒	1
你一天能挣多少钱？	一天挣个几十块吧,我也不是很会做,都是跟着人家学的	0
你不是有很多猫狗吗？	是啊，可是我不喜欢猫，喜欢狗	0
嘻哈	你也在做这行?	0
你最喜欢哪个队？	米兰!因为他们是我的偶像!	0
你最不喜欢什么？	我不喜欢的多了	0
你叫什么名字？	我是13届的哦	0
是的，你这么晚才吃东西？	我在等你喂我	0
谁在看小月的相声？	我在看啊，我觉得挺好看的	0
你听了多少年了？	小学六年级听的,现在大三	0
你学了多少年？	三年啊,我今年刚毕业	0
好的，你很讨厌打排球吗？	没有,只是不喜欢排球比赛,比赛的时候太紧张了	0
你呢，也很忙吗？	是啊!不忙!但是很无聊!	1
什么时候休息？	明天休息,后天上班	0
你知道我喜欢什么咖啡吗？	不知道。	0
你知道我多大了吗？	你多大我不管,我就只知道我5岁	0
你多大了？	我24了，你呢？	0
负责调查的人叫什么名字？	我叫张晓敏，这是我的名片。	0
你就读的学校叫什么名字？	我不想告诉你,你是哪个学校的老师啊	0
哦，你通常喜欢做什么？	打理下我的小店,也就是三四千左右,顾着生计	0
你知道我最喜欢的乐队是什么吗？	不知道,我只听英文歌,不知道国内有什么乐队	0
哇喔	是我喜欢的人不喜欢我,是我追不到的人	0
嘁	我还没去过呢,准备今年冬天去	0
你星期几去网球场？	一般都是周二周四	0
第一次发生花了多少个月？	这个月是第一个月，之后就没了	0
你知道我住在哪个县吗？	我不知道,但是我知道你是男的	0
噢噢噢	你有什么事吗？	0
哪一代人不是你们的一部分？	我听过,但没怎么注意	0
我不喜欢唱歌。我讨厌听音乐。你通常不喜欢做什么？	不喜欢的事情太多了	0
你提出来了吗？	提了啊，我说了啊，可是他不理我	0
你一天中什么时候必须去？	下午5点到6点之间。	0
你能演奏什么乐器？	我也不知道，我就会弹吉他。	0
、	你要加盟么?我可以教你	0
你知道我喜欢多少首歌吗？	额,不太清楚,应该是不少的吧	0
你知道我什么时候一个人看吗？	我不知道啊,难道是午夜?	0
你将来不找份厨师的工作吗？	不找了!我现在学的是酒店管理!	0
是的，你是做什么的？	电商运营，你呢	0
你知道我上的课叫什么名字吗？	不知道,难道是什么?	0
你知道我什么时候喜欢骑自行车吗？	我不知道，我只知道我喜欢你	0
你竟然还玩滑板，你是一个在校生吗？	我是在校生,你呢	0
哦，你不是很喜欢花吗？	是的,但是我不想养了	0
你是哪里人？	哦,我是山东人	0
哦对了	你是做什么工作的？	0
你篮球打得很好。你是学校篮球队的队员吗？	不是啊,我只是爱好篮球	0
你以前学过什么专业？	你现在有什么意向专业?	0
嗯啊	有没有兴趣一起努力啊	0
你有没有养小植物？	有啊，你要养吗？	0
你知道和我在一起的人是几岁吗？	那你几岁?和你在一块的人多大?	0
你什么时候毕业？	明年6月,不过我不读这个学校了	0
你在哪开的酒吧？	武汉汇美广场那边，江汉路那边。	0
我早上吃的酸奶和煎蛋，你早上喜欢吃什么食品呢？	豆浆，包子，豆浆油条，包子!	0
可以哦	你是做什么工作的？	0
你能给我一个机会吗？	我不认识你怎么给你机会啊,你要自己来争取的	0
唉唉唉	怎么啦,想你还叹气	0
你知道我的孩子多大了吗？	不是说五岁吗?	0
你知道我去哪里散步吗？	不知道!	0
你去过哪里？	我在北京，你在哪？	0
那你有最讨厌的书吗？	没有，我只是喜欢看而已。	0
你什么时候上的大学？	我是14级的,去年毕业的,我现在已经开始工作了,在武汉	0
哇啊，你很会享受啊，那你很讨厌吃零食咯？	我不喜欢零食!但是我喜欢吃饭!	0
你怎么了？你能告诉我吗？	不知道怎么说，就是感觉很喜欢。	0
今天是几点？	下午四点开始，你要来吗？	0
你忙着学习吗？	也不忙吧,反正我也不怎么喜欢学习	0
是的，爱是美丽的。你没有恋爱，但是？	谈恋爱,没谈结婚	0
我有时间和你一起学习怎么样？	好啊!不过我也不知道什么时候有空呢!	0
你也讨厌狗狗吗？	狗狗怎么会讨厌,我最喜欢狗狗了	0
你知道我是哪个队的教练吗？	难道是我的教练?	0
你知道我妈妈几岁了吗？	不知道。	0
你好，你能给我一些建议吗？	你想要什么建议呢？	0
你是谁？	我是一名普通的山西人	0
就叫我小明吧。你叫什么名字？	我叫王小黄!	0
你好，你不能说话吗？	可以说话呀	0
自从服用避孕药以来，你瘦了多少公斤？	你怎么能把我想的那么龌龊呢,我才没有吃那种东西呢	0
你什么时候出去的？	昨天下午，现在已经在学校了!	0
你知道我领导的合唱团叫什么名字吗？	不知道。	0
你工作的公司叫什么名字？	你在福田做什么工作呀?	0
人们常说我是搞公关的。我来自山东。你从哪里来的？	我也不知道我到底来自哪里,可能我是天上的仙女吧	0
真好啊，那你家长是做什么劳作啊？	我父母都是医生，他们的工作很轻松。	0
你知道我什么时候是大二的吗？	不知道。	0
你不吃什么？	我不喜欢吃火锅!	0
你一点都不喜欢打台球吗？	不喜欢，我只喜欢看别人打。	0
你独特的爱好是什么？	我喜欢看书，看电影，看书!	0
！！！	你是哪个学校的啊？	0
唉	你也是河北的么?	0
嗨嗨	嗨，你在哪个城市？	0
你父亲当厨师有多少年了？	我也不知道,10年前他就去了,一直在国外,今年回来的	1
我住在哪里？	你是安徽哪的？我是合肥的!	0
你失业了吗？	是啊，失业了，你在哪呢？	0
你不是太简单了吗？	是简单,不知道能不能做到	0
你知道负责这个项目的人叫什么名字吗？	不知道，我也是听别人说的	1
你还在学校。你在几年级？	我是说你在学校教书吗?	0
你知道我叫什么名字吗？	不知道,你也叫姜昕吗	0
我觉得做志愿者很有意义。顺便问一下，你过去想当志愿者吗？	我是想去	0
王林所服务的部队叫什么？	我不知道，我只知道他们的名字。	0
你知道我的家人住在哪里吗？	上海闵行区	0
目标仍然很高。我觉得你的学习也很好？	呵呵，还行吧!	0
这是你的主业还是副业？	现在是副业	0
你喜欢听谁的相声？	我不喜欢相声	0
你现在在哪家企业工作？	你在哪里做?我之前也在小企业	0
喜欢，我去满洲旅行过，你呢？	我去过新疆	0
你从事销售工作有多少年了？	我现在是做房地产销售,做了三年多了	0
呦呵	哈喽，你在哪个城市？	0
你知道你见过这些生物吗吗？	我没见过,但是我看过视频	0
喔喔	煎饼果子!	0
你什么时候去上班？	过几天吧,嘿嘿	0
是	在哪里上班啊？	0
那你会经常来野外采风吗？	我经常在野外拍	0
开车需要多少天？	不知道啊,看我自己想玩多久吧	0
嗨喽啊	嗨喽,你是?	0
你知道我听的那本书叫什么名字吗？	不知道啊,我一般不看书	0
你知道我在宿舍看了什么电影吗？	你说啊,看我猜的对不对	0
我通常喜欢玩游戏。你还有其他爱好吗？	我也是,你说的游戏我都玩	0
嗨喽	嗨喽，你好，我是你的粉丝。	0
你真的不想做什么？	现在不想,想了也没用,还不如想想怎么挣钱呢	0
你好，丫头，你在织毛衣吗？	我在织袜子!	0
你是谁？	我也叫赵武	0
你知道我在哪个城市长大吗？	不知道，只知道你是成都的。	0
你什么时候睡觉？	我是夜猫,睡得晚,起的也晚	0
你知道我来自美国的哪个地区吗？	美国的东部?中部?西部?	0
你不想换工作吗？	暂时没打算换	0
沧州在哪个省？	沧州在河北省,和北京挨着	0
呜	吃什么呢,给点意见呗	0
你知道我多大了吗？	不知道，我只知道你在北京	0
哟呵	酷我音乐盒有	0
好呀，没有问题呢，你是做什么劳作的呀？	我是做工程预算的，你在哪个城市？	0
为什么，这还不足以吸引你吗？	因为你不知道我是谁!	0
你知道我喜欢谁吗？	不知道，你喜欢谁？	0
你的家在城市的哪个地方？	我家在东北，现在在北京!	0
你结过几次婚？	我没有结过婚	0
你知道我一周读多少本书吗？	不知道啊,我也很喜欢看书,但看的书很少	0
哇哦	那你觉得你现在有喜欢的人吗?	0
你现在住在哪里？	我住在火车站附近的一个小区里。	0
你离开哪里了？	离开南京了，离开了你!	0
紫禁城在哪里？	在那遥远的地方!	0
顺便问一下，你从哪里来的？	我是安徽的,现在在成都读书	0
早上好，你起得很早。你也早起做饭吗？	我是醒了,不做饭的,都是老公做饭	0
在超市劳作也不清闲呀，你怎么这么清闲呢？	我是忙里偷闲啊!	0
小妹妹，你会跳舞吗？	我不会,你教我吧	0
那你可以说一下在听什么歌曲吗？	现在在听,走样	0
是的，你玩过腾讯的逗逗乐乐吗？	没有啊,好玩嘛?	0
你这些天都在做什么？	上班啊，没什么事做啊!	0
我也喜欢呀，我喜欢爱情一类的电视，你讨厌看什么呀？	我最不喜欢的是韩剧	0
我在看书。你喜欢读书吗？	我也在看书，你在哪里读书？	0
你知道我什么时候去上班的吗？	那你告诉我，我就知道了	0
~~~	我今年第六年了,教的初中数学	0
你知道贵阳在哪里吗？	知道啊,我也在贵阳	0
嗨喽	嗨喽，我也很想知道。	0
它不容易。你将来不想当律师吗？	当然不是啦,我要做医生的说	0
一天中哪一部分是相同的？	除了早餐和午餐，其他都是一样的!	0
这对你来说并不容易。你父母是做什么的？	父母都在老家种地	0
那你会很不舒服。你太累了，工作太多，睡眠太少。你的身体能忍受吗？	我觉得我的身体已经习惯了!	0
你知道我多大了吗？	不知道，我只知道你比我大。	0
看来你是真的很喜欢当老师呀，你平时业余时间都讨厌做什么？	我没有讨厌的事情,我很喜欢我的工作	0
非常感谢。你有女朋友吗？	没有，我是单身贵族!	0
你好，我最近一直在挣扎。你能给我一些建议吗？	你可以具体说一下你的情况吗?我才知道你应该怎么办	0
~~~	你也喜欢明信片吗？	0
哎哎哎	你在哪里上班啊？	0
你不想换工作吗？	不想啊,你换了?	0
你什么时候去公司开会的？	早上七点就到公司了呢	0
你知道我多大了吗？	不知道,反正比我大	0
你什么时候看到的？	我也是大二,我大一那会就有了,当时就觉得好神奇,居然是真的	0
我18岁生日是什么时候？	那谁知道你什么时候	0
你是哪里人？	石家庄,你是廊坊的?	0
别这么说。你是做什么的？	我是做平面设计的!	0
我是会计。你去上班了吗？	我还没呢，你在哪个城市？	0
你第一次来这里是什么时候？	我不记得了，我只是在这里长大的	0
呦	你怎么也不看看我是什么时候发的	0
那你空闲时间都厌烦做什么啊？	看书，听音乐，发呆，看书	0
那你最喜欢什么植物啊？	喜欢,有很多,不知道你说的哪种	0
你知道他哥哥什么时候待在家里吗？	他说他哥哥在家待了两年	0
你烤红薯用什么？	我也不知道。	0
你多大了？	大二的,你大几呀?	0
嗯嗯	你的回复怎么都不见了?	0
我也很怀念院所的过活，你在院所过的怎么样？	还行，挺好的!	0
和你在一起的人是几岁？	他比我大一岁	0
你儿子多大了？	比你儿子大,哈哈	0
你知道这房子有多少只猫吗？	不知道,反正这只猫咪是我最喜欢的	0
你喜欢什么运动？	我最喜欢网球,你呢?	0
你在这座城市多久了？	一年多了吧!	0
你知道我在哪里能买到猫吗？	不知道，我也没养过猫	0
对了，我不知道你是干什么的？	我是做平面设计的，你是做哪方面的？	0
我刚扫完地板。你看了什么电视剧？	我的团长我的团,你呢?	0
太好了。平台上还会有很多粉丝吗？	有啊，不过都是僵尸粉	0
大一是哪一年？	现在大一,16年大二	1
我养什么品种的狗？	你喜欢啥养啥	0
你叔叔在商场推销火锅食材和底料，你讨厌吃火锅吗？	不讨厌，只是不喜欢。	0
你知道我是谁吗？	你是谁?你不说我怎么知道	0
你有不同的工作时间吗？	一个月四天公休,一天工作三个小时	0
你想申请什么职位？	我想问一下有什么职位呢?	0
你在哪里唱歌？	现在在北京的一个酒吧	0
我有几条狗？	是宠物医院不是宠物店	0
你好，你现在做什么？	做业务,你呢	0
对了，我不知道你是干什么的？	我是卖房子的!	0
你知道我什么时候喜欢听音乐吗？	我不知道，我什么都不知道!	0
你知道我四岁是什么时候吗？	不知道,你说说看	0
你知道我工作的工厂在哪里吗？	不知道，我只知道你是一个机修工。	0
嗨，我是一名会计，我在一家储蓄所上班，你呢？	还没毕业呢,明年毕业	0
你竟然为了去玩而抛弃了你的劳作？	没有,这不工作了一下午了,还没开始玩	0
太好了。你是在网上买的吗？	嗯,是的呢,不过我是在一个叫芊芊园艺的店铺买的	0
你知道我当兵多少年了吗？	我不知道啊,那你说说	0
法国斗牛犬来自哪里？	你朋友养不,不养我就给人了,我也没法养	0
你什么时候能去杭州？	不知道啊，还没定下来。	0
你是哪一年的？	96的,你呢?	0
我也挺喜欢我的劳作的，你是做什么的？	我是做外贸的，你在哪里呢？	0
哎哎哎	你是男的还是女的？	0
有时的，最近很苦恼，我跟你说说吧，你愿意听吗？	可以的,你说就好	0
你最喜欢他们的哪种音乐？	最喜欢的话就是,我不想让你一个人吧	0
你知道谁是乐队的鼓手吗？	不知道，你知道吗？	0
我也很高兴见到你。你现在在做什么？	我是开网店的,你是做什么的呀?	0
你知道谁是我最喜欢的明星吗？	不知道	0
你知道我最喜欢什么季节吗？	我也不知道，我只知道我喜欢冬天	0
诶呀	你在哪里?找不到工作?	0
你有多胖？	我不胖,也就一百二十几斤吧	0
你知道老师教什么年级吗？	你告诉我就知道啦	0
我什么时候吃饺子的？	你不知道吗？	0
你知道我多大了吗？	不知道，我只知道你比我大	0
是	好啊,你给我留个微信吧	0
我参加劳作了，一周劳作五天，你是做什么劳作的？	我在设计院做设计	0
保安老哥你好啊，你平时讨厌做什么啊？	我讨厌睡觉，不喜欢睡懒觉!	0
你知道我多大了吗？	不知道!	0
我也是，你在忙劳作吗？	是的，我在忙着工作!	0
呃呃	我才刚开始学	0
顺便问一下，你喜欢在业余时间读书吗？	以前喜欢,现在都不知道看什么	0
谁是申腾的好朋友？	申腾没有好朋友,都是好朋友	1
你还有宠物吗？	现在家里只有我一个了	0
在俱乐部里，我已经完成了我正在做的事情。你在做什么？	我在做我的工作啊!	0
我最喜欢的乐队是844乐队。你听不见吗？	我只认识844的	0
你知道我最喜欢的乐队是什么吗？	你说出来,看我听过没,	0
你假期做什么？	吃饭睡觉打手机啊	0
你也讨厌花花吗？	我是河南的,我也不喜欢那个花花	0
没问题。你是做什么的？	我是搞设计的啊,你那?	0
你和父母住在一起吗？	是的,住一起	0
你知道我有多少只宠物海龟吗？	不知道，我只养过乌龟	0
你知道我什么时候去潜水吗？	不知道，我也不知道!	0
你知道什么时候有人邀请我出来的吗？	不知道,那人是谁?	0
你是从哪里毕业的？	北京啊，你也是体院的？	0
我也很高兴。你通常喜欢做什么？	我也是,你喜欢什么	0
你花了多长时间才康复？	我花了一年时间,我比较严重	0
你现在做什么？	我学的环艺	0
你喜欢什么样的天气？	我喜欢阳光灿烂的日子!	0
你将来打算做什么？这个专业的出路是什么？	我不知道，我只知道我不想当老师。	0
是的，你通常看电视吗？	不,电视剧都很少看	0
看看你说我有多粗鲁。我也很精致，好吗？	那你说你哪里精致了	0
谁是流行歌手？	他们都是啊	0
哦，太远了。你还喜欢做什么？	发呆是一种生活态度!	0
你好，请问你穿西装干什么？	我穿工作服有什么不对吗？	0
碧熊，波美，还有其他什么人可以？	这是我喜欢的三种	0
你知道谁写的《生命中最美的是清欢》吗？	我知道林清玄	0
你来自哪个地区？	我是广西的,不过我现在在广东	0
你好，你可以不说话吗？	可以,给钱就好了	0
我也很高兴见到你。你叫什么名字？	你连我都忘了,还说我不知道你名字	0
两份工作你都做什么？	销售的是金融,前台接待的是超市收银	0
谁是流行歌手？	不太关注流行,我喜欢的是古风歌,比如河图的,董贞的	0
你知道我喜欢里面的谁吗？	不晓得,你说嘛	0
我也很喜欢。你印象最深的是什么？	最喜欢的就是北京和上海了。	0
那你是怎么厌恶上歌剧的？	我不是厌恶，只是不喜欢而已。	0
啊好	你呢,过的怎么样?	0
我最喜欢的电视剧是《人民的名义》，我这两天都快看到大结局了，你厌恶看吗？	我不厌恶看	0
~	现在在做什么工作?	0
你上的是哪所大学？	广工啊，你呢	0
你很久没写这篇文章了吗？	是的,有三个月没写了	0
你有几条狗？	三条，一公一母。	1
哇啊，你很会享受啊，那你很讨厌吃零食咯？	不讨厌，只是不喜欢吃!	0
什么时候在城里散步好？	这个...我也不知道啊!	0
你知道我多大了吗？	你多大跟我有一毛钱关系啊	0
是的，我想去很久了。你呢？	我也是,我是去年暑假去的,	0
你好，你好，你也是女孩吗？	对的,我也是女孩	0
你知道我来自哪个国家吗？	不知道啊,是哪国	0
你好，你起得这么早？	是啊,我每天都是这个时间起床	0
你不喜欢去咖啡馆吗？	还好,不是很喜欢	0
网店一个月赚多少钱？	也没多少,也就三四千吧,够自己的生活费了	0
啊，这不是件小事吗？	对啊，这是件大事!	1
你多久打一次电话？	一天一次,一次半小时	0
感觉也很好。你应该有很多粉丝，对吧？	嗯，是的，我还有很多僵尸粉!	0
你知道她死的时候我多大吗？	她在18那年去世了,你多大?	0
你知道我喜欢走什么吗？	不知道，你说说看!	0
你知道我讨厌什么吗？	讨厌夏天的蚊子吧	0
对吧	嗯嗯,你是做什么设计的,感觉挺厉害的	0
很棒，你已经劳作了吗？	劳作的很辛苦,很怀念学校的日子	0
有多少个校区？	一个老校区,一个新校区,你的这个专业在老校区	0
是的，你不是经常来郑州玩吗？	是啊，不过最近没时间，下次吧。	0
你知道我的家族是什么种族吗？	不知道,你不说我也不知道	0
好吧，那你是做什么劳作的啊？	我是做服务业的，呵呵!	0
~~~	你是怎么减的?运动吗?	0
那你有没有来图书馆问他们要不要招人呀？	你问我的时候已经招了	0
哪个城市以老潭腌菜牛肉面闻名？	不知道,反正我喜欢吃	0
那你们的工作时间短吗？	不短，只是偶尔加班而已。	0
哈哈	你也是女生呀	0
你怎么在家劳作这么自由呀？	因为我有自己的店铺可以经营,而且还做微商,所以比较自由点	0
嘁	做的怎么样?我是做设计的	0
你讨厌看橄榄球吗？	我不讨厌,但是我更喜欢篮球	0
谁是我最喜欢的球员？	我也不知道，我只知道我喜欢科比!	0
对不起，你是本地人吗？	没事,我不是本地人	0
是不是你回的地方鱼比较老啊？	不知道啊，我都没去过	0
你知道我多大了吗？	不知道，我只知道你在干嘛。	0
哪个国家有很多文学作品？	英国,美国,法国,意大利,荷兰	0
我是一名投资分析师，专门为客户提供咨询服务。你参加工作了吗？	我也是一名理财顾问，我也想加入你们的团队	0
开网店要花多少钱？	一个月三四千块钱就可以了	0
那还真是有点可惜了，你现在还想教吗？	当然想啊!	0
你知道我什么时候请假的吗？	不知道，你是做什么的？	0
你知道我多大了吗？	不知道,你说一下啊	0
你来自哪个地区？	我是江苏的哦	0
你从事销售多久了？	一年多，之前做的是销售助理。	0
你知道我什么时候去购物吗？	我不知道。	0
没事的，你现在是已经劳作了还是在上学呢？	我已经毕业了，现在在上班!	0
真正地你多大了？	我还没成年,我还小	0
是的，你是做什么的？	我是做平面设计的，你呢	0
可以啦	你找到的是什么工作啊?	0
我最近在练手风琴，准备考风琴六级呢，你呢？	我也是手风琴。一起加油吧!	0
我什么时候能找到像你这样的工作？	那要看你的兴趣	0
你知道我多大了吗？	反正肯定比我小	0
我多大了？	你多大？	0
哇塞，这么厉害啊，你很讨厌跳舞吗？	不讨厌，只是不喜欢。	0
这么厉害，那你现在可能有时间看电影了吧？	有了,不知道看什么	0
我30岁了。你不是高中生吗？	我是说我今年三十岁了，还没有毕业!	0
你平时除了歌唱没有其他的爱好吗？	打篮球,唱歌,都可以	0
你什么时候看到的？	我是在微博上看到的	0
你知道我喜欢什么时候出去吗？	不知道，我也不知道!	0
你来自中国的哪个地区？	我来自东三省，你呢？	0
谁是中国流行歌手？	陈绮贞，梁静茹，陈绮贞。	0
那你的劳作时空应该很自由吧？	是的,很轻松	0
呃呃	你呢,哪里的呀	0
我喜欢看影片，最喜欢的就是纪录片，你有什么爱好呢？	我喜欢摄影，喜欢记录生活中的点点滴滴!	0
你的父母来自中国东北吗？	是啊,我爷爷也是	0
你上班时还有时间玩手机吗？	我上班都有时间看电视的,你说呢	0
！	怎么了,你是做什么的?这么清闲?	0
你完成高考了吗？	嗯,高考完了	0
好的，你很讨厌打排球吗？	没有啊,你想太多了吧	0
你喜欢读书吗？	不喜欢，我不喜欢那些书	0
你经历过这种情况吗？	经历过，我的钱都是我妈给我的	0
你多大了？	我也是90的	0
嗯嗯嗯	我想找个男朋友结婚,然后我就可以不工作了	0
你通常什么时候去？	我一般都是晚上去，早上起不来。	0
真正地你多大了？	我比你大,24了	0
我有几个女儿？	你不是说两个吗?难道有三个?	0
啊，那你和家人团聚的时日是不是很少呀？	是啊，都是我自己在家。	0
真正地你多大了？	我也22岁啊,我们一样大哎	0
嗨喽	嗨喽,你是哪年的?	0
你想去哪个国家？	我想去泰国，不知道能不能成行。	0
你好，能和我谈谈吗？	当然，请说吧!	0
这是国家的政策。当然，我知道。你什么时候上下班？	我们上4天休2天,你是什么工作呀	0
还有陈奕迅、孙燕姿、张惠美和陈奕迅，谁是这一集的主角？	孙燕姿吧，我也不知道是谁	0
是的，你刚才说你想周末去露营，是吗？	是的，我想和你一起去露营	0
你好厉害呀！你通常都厌恶画什么画？	这个,没有讨厌的,只要是自己喜欢的,画不好也会鼓励自己继续画	0
你在哪里？	我在天津,你呢	0
你很厌恶跑步啊？	不啊,很喜欢	0
怎么了你不是经常玩吗？	我啥时候玩了	0
你现在不是在上高中吗？	是啊，可是我已经毕业了。	1
那业主去饭局一定会带着你吧？	这个就不知道了。	0
哎	为什么叹气呢？	0
你是一个学生吗？	我不是啊,我都是孩子的妈了	0
我教哪门课？	你教什么我就学什么	0
诶	我也是个吃货,不过我最爱的还是水果	0
哇，太酷了。你一个人住吗？	我一个人在一栋房子里,一个人睡一间小的	0
你不适合什么行业？	建筑工程技术,我觉得太累了,我还是适合做我的销售	0
嗯呢	你有什么工作介绍啊	0
主要原因是我没有精力。我厌倦了每天抚养他们。你没有宠物吗？	没有，只有一只猫!	1
你有什么比较难办的东西吗？	我有一个非常难办的问题	0
网店每月收费多少美元？	不收费,我加盟做的	0
好的，你没有什么爱好吗？	看书,听歌,运动	0
那你讨厌看什么类型的电影呢？	不喜欢爱情片，也不喜欢励志片	0
你也没有宠物吗？	有猫和狗呀	0
是呀，夏天到啦，大家伙儿都喜欢吃夜市，你们餐馆有没有准备夜市啊？	当然准备了，我们这里的夜市可是远近闻名的。	0
~~~	那你现在有吃晚饭么?	0
你在做什么？	我在看电视剧，你呢？	0
你知道我特别喜欢哪个国家吗？	我不知道啊，我只知道我喜欢的国家	0
你知道我最喜欢哪部电影吗？	夏洛,特烦恼?	0
啊，那你和家人团聚的时日是不是很少呀？	是啊，我家人都不在家	0
成年人的年龄范围是多少？	不知道啊，我也不知道。	0
你什么时候骑马？	我现在就在骑马啊，你也在吗？	0
我刚才在读书，放松下情绪，你喜欢读书吗？	喜欢，我喜欢看书!	0
嗨，你好呀，今天来上学了吗？	是啊，今天有什么事吗？	0
哈咯啊	你平时做什么呢?	0
不，这只是一篇普通的期末论文。我只是一名大二学生。你做什么工作？	我做审计的，现在在做审计助理。	0
你知道学生在哪个国家吗？	不难呀,很简单的,只要好好学就行了,我就是学意大利语的	0
确实，听说他的成绩很高，那你最喜欢他的哪一首曲子呀？	月光，月光，月亮之上，月光!	0
你知道我搬到哪里去了吗？	不知道,我以为你去了上海	1
你喜欢读书吗？	不喜欢，我只喜欢看电视	0
你在哪里学习？	我在国内啊,还没去	0
这首歌是谁写的？	孙燕姿	0
你什么时候完成高考的？	6月啊,我6月7号就考完了	0
你家有几条狗？	三条啊	0
你知道我的家在哪里吗？	不知道，我只知道你是烟台的。	0
你有几个孩子？	两个，两个女儿，一个儿子。	1
哦哦，那你讨厌什么颜色？	除了灰,其他都还好	0
你不想练习吗？	想啊,我现在就在医院实习	0
你在哪里工作了三年？	我在北京，现在在上海。	1
你知道我有多少腹肌吗？	不知道!	0
你好，我是素食主义者。你呢？	我也是，我喜欢吃素	0
你知道我什么时候和朋友去滑板吗？	不知道啊，我也不知道!	0
是的，你写小说赚很多钱吗？	没什么钱赚啊,现在一本都没签约	0
除了画画你还有工作吗？	有啊，不过我现在不做了。	0
你很厌恶写作吗？	不啊,只是不想把时间都浪费在写作上	0
！！	你多大啦？	0
哇塞，你养那么多狗狗啊，你是做什么劳作的？	我是打杂的!	0
你喜欢糖吗？	那你喜欢吃什么糖呀?	0
嘿嘿对	你也看球?	0
你看的什么影片呀？	《再见，我们的幼儿园》	0
你有多高？	你猜,哈哈,肯定没你高	0
哈哈	你家孩子多大了呢?	0
不，我只是对我的家庭不满意。你是做什么的？	我是学生，我也不知道我做什么!	0
你来这座城市有几个月了？	两个月多吧	0
是的，你玩过腾讯的逗逗乐乐吗？	没有哎,那是什么	0
你叫什么名字？	我叫李小二，你呢？	0
你知道我不认识哪个著名的作曲家吗？	我也是,我只知道巴赫是个著名的作曲家	0
你知道我多大了吗？	我不知道,我就想知道你的父母是不是很开明的人,	0
请问你现在做什么？	我是一个小小的会计	0
对嗯	我也是做销售啊!你做的什么	0
那你是不是特别嫉妒人家老婆？	不嫉妒,我嫉妒她老公	0
呜呜呜	我还以为我被你发现了呢,嘿嘿	0
你带孩子们出去了多少次？	三四次吧，都是他们带我去的。	0
那是一个很厉害的校园，你有把握吗？	那好吧,我再考虑一下别的吧	0
谁的歌特别有挑战性？	我唱歌不好听,你唱	0
那你以前为什么想当记者？	因为有人说我可以去当记者,而且我也觉得挺好玩,所以想试试	0
嗯对	对啥啊,我是女的	0
我喜欢什么电影？	不知道你喜欢什么,但我觉得夏洛特烦恼不怎么好看	0
你是一个很有雄心的人物，那你住员工公寓楼吗？	不是啊，我住的是老房子。	0
你想去的城市叫什么名字？	我想去的地方太多了，不知道你说哪个？	0
呃呃	我现在一个人在家,都不知道要干嘛,好烦	0
“狗蛋”是什么品种的狗？	就是土狗啊!土狗!	0
你知道我喜欢什么季节吗？	不知道，我喜欢冬天!	0
是的，我以前去过蹦极。你没玩过蹦极吗？	没有，从来没去过，也不想去	0
负责调查的人叫什么名字？	我叫张浩宇，你是哪个部门的？	0
你知道我失去了什么吗？	失去了一个王者荣耀	0
你很讨厌讲故事吗？	不是,你是不是有个喜欢的人,然后你们在一起了,他不讲故事给你听?	0
哦，我明白了。你打算怎么办？	我不知道。	0
你平时应该很自由吧？	是的啊,挺自由的	0
你一个月挣多少美元？	挣个零花钱,买个手机	0
我最近一直在学习。我大部分时间都在网上上课。你不喜欢动物吗？	我不喜欢，我喜欢狗狗!	1
是啊，我就是这么以为的啊，没有学习者你们去院校干嘛？	我们去玩啊!还能干嘛!	0
他有几个女儿？	一个女儿，一个儿子，还有一个小女儿!	0
那你平时劳作忙不忙呀？	忙啊，有时候忙有时候不忙	1
我刚刚下班，刚刚忙完，你来干什么了？	我是来找你的。	0
我孩子的孩子多大了？	你的孩子是我的孩子，你说呢？	0
哪里容易找到广告工作？	这个就不知道了，你可以去招聘网站看看	0
你好，你想要只小猫吗？	你好,我已经养了一只了	0
你是谁？	我是你的小粉丝儿	0
哇啊，那你讨厌看什么电影啊？	不想看的电影	0
顺便问一下，你有什么爱好吗？	看书,电影,动漫,小说,动漫电影	0
我所在的班级叫什么名字？	你是哪个学校的？	0
游戏中角色的名字是什么？	我也喜欢玩,你是什么段位的	0
有多少人在岛上工作？	这个就不知道了。	0
你知道我喜欢在哪家餐厅吃薯条吗？	不知道,那你告诉我吧	0
哦哦	你也喜欢看盗墓笔记吗?	0
现在很晚了。你吃过晚饭了吗？	吃过了,都在宿舍了	0
你有小动物吗？	有啊，你要养吗？	0
你过活挺丰富的嘛，你劳作了吗？	还没有呢，要等到明年才有时间呢!	0
你一个月只休息两天。你不累吗？	不累,我是做设计的	0
为什么？你是做什么的？	我是做互联网的，只是在这里工作而已!	0
你不是很喜欢饺子吗？	我喜欢吃的东西多着呢	0
你现在是运动员了吗？	不是,我是业余的	0
你什么时候去瑜伽？	最近都有去，不过都是晚上。	0
那你一定画得很好看吧？	还好啦，你呢？	0
你妈妈是做什么劳作的？	卖鞋卖袜子的?	0
你知道我一周在剧院演出几次吗？	我怎么会知道?我又不是你	0
你住在哪里？	我住在大学城这边，离你远吗？	0
你不是还在学校吗？	是在学校啊	0
对吗	对啊!我还会滑滑板呢!	0
你通常什么时候跑步？	晚上7点以后，早上6点左右。	0
是的，看起来很有趣。顺便问一下，你没有工作？	有工作,只是想找一个可以一起玩的小伙伴	0
你现在在哪里工作？	上海啊，还能在哪里？	0
…	这是书名?	0
哇哦	你喜欢听什么样的歌呢？	0
你好，还没醒吗？	醒了!刚醒!	0
你知道我喜欢什么样的天气吗？	不知道,我是东北的,你呢?	0
我能带他们到我家住一会儿吗？	我在北京,你在哪里?	0
你喜欢艺术吗？	我喜欢音乐，音乐是我的生命	0
你叔叔在商场推销一品锅食材和底料，你喜欢吃火锅吗？	不喜欢。	0
你不想当医生吗？	想啊，可是我不知道我能做什么	0
你在哪里学习？	我在武昌这边，你呢	0
老师很好。毕业后你不想在哪里工作？	这个,暂时还没想好,你是做什么的?	0
这是正确的。我们可以互相了解。你通常喜欢做什么？	我喜欢听音乐，听音乐可以让我安静下来。	0
很多人不经常去你的工作室录歌？	嗯,基本上都在忙自己的事情	0
我也喜欢刘德华的忘情水，我还喜欢李圣杰的歌曲，你还喜欢哪个明星？	李圣杰，张学友，周华健，张国荣，	0
你可能已经结婚了吧？	没有，不过我有个姐姐已经结过婚了。	0
店里有多少人？	不知道，我没去看	0
我们别谈纹身了。让我们谈谈你。你工作不忙吗？	忙啊，每天都忙死了!	0
你把你的家人养得胖乎乎的吗？	对啊!我爸妈都是胖子!	0
你在这里工作多久了？	两年零两个月	0
你现在是已经上学了呢，还是在劳作？	我已经毕业了，现在在上班!	0
姐姐，你工作的薪水是多少？	这个要看你的能力了。	0
你知道我忘了谁吗？	我知道啊,我不喜欢他	0
你们劳作的时候还能看书，这么轻松吗？	是啊，劳动最光荣!	0
别的地面没位置了，可以坐你旁边吗？	你坐地下吧	0
你在哪里长大的？	北京啊，你呢？	0
是的，看起来很有趣。你喜欢吗？	喜欢啊!	0
对呢	我也是啊,喜欢吃喜欢玩喜欢看电影喜欢睡觉,	0
你失业了吗？	没有,我现在是无业游民	1
你很厌恶写作吗？	没有,只是不喜欢写太多	0
你知道我喜欢在哪家餐厅吃薯条吗？	不知道啊,哪家	0
咳	这是我最害怕的三种了	0
当然，我喜欢扮演荣耀之王。你喜欢吗？	我喜欢你，你是我的荣耀王	0
你知道我有几条狗吗？	不知道,你又没说	0
你不厌倦半熟的奶酪吗？	不，我很喜欢	0
你的家在哪里？	北京啊，离你很远吗？	0
那么你的生活现在应该更稳定了？	还好吧。偶尔会有孤单的感觉。	0
我喜欢看电影。你喜欢吗？	喜欢啊，最近有什么好看的电影吗？	0
你看了多少遍？	我也不知道,反正看了很多遍了	0
谁写了一本关于情感写作的书？	不知道,就看了几页,是散文	0
我觉得我最近身体不好。我什么都不想做。我只是在家看电影。你不是经常去看电影吗？	没有啊，我很少看电影的!	0
你什么时候想吐？	中午吃的饭,吃了就想吐	0
你知道谁是这个综艺节目的主持人吗？	不知道啊!	0
你第一次去那里是什么时候？	去年十一月份吧	0
哦哦	你是学什么专业的？	0
锻炼对你的健康有益。你通常做什么？	我也上班,不过是在电脑上,你在什么地方上班呢?	0
你通常什么时候睡觉？	有时候12点，有时候11点	0
真好，大学过活是很精彩的，你一定交了很多友人吧？	没有，我一个都没交到。	0
你白天什么时候起床感到困倦？	早上七点左右	0
你打算换工作吗？	不知道,你给介绍介绍呗	0
天呐，那你还是一个电子琴老师，你们家岂不是是音乐世家？	电子琴是业余爱好,钢琴才是主业	0
你知道《傲慢与偏见》的作者叫什么名字吗？	不知道，我只知道这本书很好看	0
你知道我有多高吗？	我怎么可能知道呢	0
负责调查的人叫什么名字？	我叫李萌萌，你的名字是？	0
你知道我什么时候才是成年人吗？	不知道，我也不知道。	0
哇，你还是喜欢看今天的演讲。你不是律师吗？	不是,你是不是看谁都是律师啊?	0
你知道喜欢这款电子游戏的人的年龄是多少吗？	我知道啊!我今年刚满23!	0
呵呵，我还以为是洋人呢，我是广州的，你是哪里的呢？	我在广州读书，现在在广州工作!	0
你大部分时间想去做什么？	想去丽江，大理，香格里拉，泸沽湖。	0
啦	好吧，我还以为你在睡觉呢!	0
你喜欢什么电影？	我喜欢的类型很杂，你呢？	0
哎呦	哎呦什么呀!	0
他在哪里？	他在北京啊	0
没有，我还在学校。你是做什么的？	哦,我做的是文员,你多大了	0
你的尝试怎么样了？	还没开始呢，还在努力中。	0
他在加班所以没有出去，你都是一个人回健身房吗？	对啊，一个人在健身房	0
我喜欢什么时候骑自行车？	晚上下班后	0
我现在在昆明学习。你在哪里工作？	你在昆明学什么?我在官渡区	0
负责正在处理的信息的人叫什么名字？	叫刘梓晨	0
你知道我失去了什么吗？	你失去了一个帅气的小哥哥	0
你的职业是什么？	我是一名学生	0
啊哈哈	你呢?你的孩子多大了?	0
这对夫妇养育了多少孩子？	一个女儿一个儿子,都是我带的	0
诶呀	你喜欢吃什么？	0
可以啊	你是做什么的？	0
看你的头像可能是女孩子吧？	头像是男的啊	0
这个问题的答案是什么？	我的答案?	0
你住在哪里？	我住在西乡塘路，离大润发很近	0
谁是流行歌手？	我是说,流行歌手,我都不知道	0
你为什么没想到学西班牙语？	因为我不喜欢西语。	0
商店里有什么食物？	我是自己开店的,所以我自己都不知道我这里能卖些啥	0
可以说说你排解的法子吗？	就这样排解啊	0
哦，我对这个不太了解。你业余时间做什么？	看书，上网，睡觉，打豆豆!	0
你住在哪里？	我住在东区，你呢	0
哦这样啊，那个我喜欢烹饪，你讨厌干什么啊？	我喜欢做饭，我讨厌做菜!	0
咳咳咳	嘿嘿,我比你大一岁	0
哈咯啊	哈喽,你是军人吗	0
那你比我小，你教的什么专业呀？	汉语言文学，你呢	0
你没吃午饭吗？	吃了啊,我中午吃的特别少	0
你知道罗琳写了什么系列的书吗？	不知道，我只看过他的书	1
不过这个大学不是很好考，你有信念吗？	没有,我是个没毅力的人	0
你知道我最喜欢什么季节吗？	冬天!夏天太热了!	0
你猜疑世界上有爱情吗？	我不知道，我只知道我相信	1
哼	你是哪个学校的？	0
你不是在家工作吗？	是啊!但是我现在在上班啊!	0
你知道我弟弟在哪里工作吗？	我不知道,但是可以猜啊	0
你上的那门课叫什么名字？	我上的是英语课，你是哪个学校的？	0
你知道我喜欢听谁的歌吗？	不知道啊!你喜欢谁的歌？	0
那你锻炼身体的方式是来跳广场舞吗？	不是,是跑步	0
那是很长时间了。你一周有几节课？	三四节吧，你呢？	0
你坐了多久？	两个多小时吧!	0
一周中最忙的一天是什么时候？	周末,周一到周五都不忙	0
电影《外面》用的是什么乐器？	钢琴，尤克丽丽约翰逊的琴。	0
你知道我多大了吗？	不知道啊!	0
我住在哪里？	我也不知道你住哪里!	0
还没有。我下个月要拿到驾照。你做完了吗？	做完了，我还没去领证呢!	0
那你除了厌烦听音乐还厌烦什么呢？	烦的多了	0
你的其他同事也是这样吗？	我还真不知道,我是新人,没接触到那么多	0
周星驰的名字是谁？	周星星啊,你是故意的吗	0
是因为你刚从空调房出来，室内外温差很大吗？	是的，因为我刚从外面回来!	0
你每天工作多长时间？	每天工作时间不固定啊	0
我刚扫完地板。你看了什么电视剧？	暗黑者1	0
啊啊	你有男朋友了吗？	0
哈哈	你呢？最近在忙什么？	0
你讨厌听谁的歌？	没讨厌的,我都听	0
我也不想这么做。我别无选择，只能忍受。别提我！你每天怎么节食？	我也没节食啊!就是正常吃饭啊!	0
你好，你还没休息吗？	你好!我也没休息呢	0
你多大了？	我今年刚满18岁，你呢	0
那你永远都是孤独的。你不会感到孤独吗？	不会，我喜欢一个人呆着。	0
我也很高兴见到你。请问你几岁了？	哦!我比你大好多呢!呵呵	0
你是一个人看这家服装店还是有员工帮你看？	都有!	0
你知道和我在一起的人的年龄范围是多少吗？	不知道，我只知道我比你大	0
商队有多少钱？	没有商队	0
怎么了你不是做了你喜欢做的吗？	我做的事情是我不喜欢的,所以我不做了	0
你不是经常工作吗？	经常工作,我现在实习了,也不算经常工作	1
小霞的名字叫什么？	小霞叫小霞	0
那么，你不应该加班吗？	不加班,今天我是正常上下班,你加班了?	0
嘿，你是做什么的？	我是做电视节目的	0
呸	咋,不让说实话啊	0
那你有什么值得推荐的减肥措施吗？	你现在多重啊?我是生完孩子胖太多了,你应该很容易瘦下来的	0
你知道我住在哪个城市吗？	不知道!	0
他在哪家公司工作？	我不太清楚，他只知道他们公司有一个设计师。	0
你多大了？	我25了，今年刚毕业。	0
那你有讨厌的运动吗？	没有,都喜欢	0
你现在上高中了吗？	是的，我已经上大学了。	1
他们孝顺吗？你没有孙子吗？	我没儿子哪来的孙子?	0
那还真是有点可惜了，你现在还想教吗？	不想了，我已经学会了!	0
嗯对	你知道我是谁吗？	0
你知道我家的语言是什么吗？	不知道,说来听听	0
劳作了，我是一名儿科医生，你劳作了吗？	我在工作，你在干什么？	0
啊哈哈	你会做啥好吃的？	0
那你通常很累，你有空吗？	有啊!你要来找我吗？	0
你是什么劳作？	我现在是一个小文员而已啦	0
你好，你能告诉我你现在在做什么劳作吗？	我现在在一家小公司上班。	0
她不知道你喜欢她吗？	不知道啊，我也不知道她知不知道	0
你知道谁是一个非常好的歌手吗？	不知道啊!你知道吗？	0
你知道顾客通常什么时候有空吗？	一般晚上8点左右有空的,你可以加我微信了解一下	0
哈哈好吧，那你讨厌看电视剧吗？	还好吧,不太喜欢看	0
那挺好的，那你做事的时候讨厌做什么呢？	什么事,工作?	0
我想你应该喜欢听音乐？	是的，我喜欢音乐!	0
什么时候？	什么时候有时间都可以啊	0
你要为谁挣奶粉钱？	我自己啊,我是单亲妈妈,宝宝是我和老公的	1
你什么时候实习的？	今年6月,你呢	0
是的，它总是让人发笑。你最近有什么问题吗？	没有啊，就是觉得自己想要的太多了	0
你知道我喜欢什么样的食物吗？	我不知道你喜欢什么	0
你早上先练瑜伽吗？	是的，我每天早上都练瑜伽。	0
我买了一些银首饰。我特别喜欢银首饰。重点是我只能带银首饰。你在淘宝上买了什么？	你是怎么了?为什么不能戴?我还买过很多金银玉石,都是自己收藏的	0
哎哎哎	怎么了?你那没有吗?	0
你所在的城市在哪里？	我在北京，你呢？	0
一年级学生的平均人数是多少？	不知道,大概两千人左右	0
一年的光阴你还没有交到好友人吗？	没有啊，我都不知道该怎么办!	0
你现在和你父亲住在一起吗？	对的,我和我父亲住一起	0
请问你是做什么劳作的？	我是做室内外装修设计的	0
你通常挣多少钱？	你是干什么的呀?挣这么多	0
你知道我更喜欢哪种动画片吗？	迪士尼的我只看过一部电影	0
对啊	你喜欢什么样的人？	0
你知道我喜欢什么时候跑步吗？	晨跑的话是什么时候	0
今天不忙，你没放工吗？	放了,我都在看电视剧了	0
你不觉得自己想得太多了吗？	可是真的不知道该怎么去做	0
是啊，看你穿的运动服，是去体操房了吗？	没有,在家里的	0
你不是要退休吗？	是啊，我也想退休啊!	0
你知道我什么时候一个人看吗？	不知道,你说说看	0
哪里有稳定的工作？	在哪里都有,看你能不能吃苦了,我也刚来深圳	0
那你会很不舒服。你太累了，工作太多，睡眠太少。你的身体能忍受吗？	我的身体还好，只是最近有点累!	0
你从哪个方向来？	我是从东北来的，现在在北京!	0
是的，你没在工作。你有空吗？	有啊，我现在就在上班啊!	0
？？？	嗯,我也是独生子的,我不喜欢跟父母住	0
你会画漫画吗？	我会画画，不过画得不好看!	0
有多少年了？	快十年了吧，也许是上辈子的事了	0
你知道几天前，我什么时候去听音乐会的吗？	我不知道，你知道吗？	0
你什么时候实习的？	我也是今年实习的	0
这样啊，那你找到了有关于市场营销的劳作了吗？	找到了,但是不知道适不适合你	0
你有多少只猫？	两只，还有一只是公的，一只是母的	0
你知道我最喜欢的电影是什么吗？	不知道，你说说看!	0
好吧，我没有太多时间锻炼。你从哪里来的？	我是成都的，你呢？	0
你的月收入是多少？	也没多少吧一天也就几百块,够自己花了	0
是的，但是他们最近很忙，几乎没有时间带我去。你是做什么的？	我是做服务业的，你在哪个城市？	0
你好，我现在心情不好。你能和我聊一会儿吗？	可以啊，你想说什么呢？	0
被你的父母亲照顾的感觉不好吗？	不好!没感觉啊,	1
你也是北方人士吗？	是的,我是河北的	0
是的，你呢？你是做什么的？	我是一个苦逼的小职员	0
我觉得我最近身体不好。我什么都不想做。我只是在家看电影。你不是经常去看电影吗？	是啊，我也不知道为什么，就是喜欢!	0
啊啊	你可以去学啊	0
可以啊	有什么问题可以问我啊	0
…	你怎么了,我是因为被狗咬了	0
是的，你以前做过什么？	在酒店里做销售,做了一个多月,没业绩,就辞了	0
是的，你今年多大了？	我也22,不过现在都是孩子们的天下了,感觉自己老了啊	0
能和你交个友人吗？	那要看我愿不愿意和你成为友人啦	0
你知道我来自哪个城市吗？	不是北京的?	0
当然要我教你画花吗？	嗯嗯,楼楼真好	0
我不会。你在哪里练习射击？	学校附近靶场,我也只是打过几次而已,不会很难	0
哇哦	你哇哦什么啊	0
你知道去年我进了多少球吗？	不知道，你是哪个队的？	0
你刚说你从福利院出来。你在福利院工作吗？	是的，我在这里工作。	0
你知道我喜欢谁吗？	你喜欢我,我知道	0
你一定很喜欢狗吧？	是的,超爱狗	0
你好，你还没休息吗？	我是夜猫子,你呢?你是做什么工作的?	0
你不是很喜欢看新闻吗？	是的,我不爱看电视剧	0
哇，我真羡慕你。你业余时间喜欢做什么？	我也不知道，我喜欢发呆。	1
除了壁球，你还有其他爱好吗？	壁球是啥？壁球又是啥？	0
你知道我喜欢去做什么吗？	你喜欢做什么？	0
我能和你谈谈吗？	可以啊，只要你不嫌我烦就好	0
你一个月挣多少美元？	好吧,我平时没事,也想开个网店,能不能带带我啊?	0
我是搞科研的，在生物体研究所劳作，你呢？	搬砖啊,不搬砖你养我啊	0
呀	你家的狗叫什么名字？	0
你真的是一个很乐观的人士，你是自己在外打工吗？	是的，我是一个坚强的人!	0
可以呀	好的啊,怎么联系你啊?	0
谁写了一本关于情感写作的书？	三毛啊	0
是的，有电视版。你看到了吗？	看了,看了一点,就看不下去了,感觉好假,不知道为什么那么多人喜欢看	0
你已经结婚三次了。你家的条件好吗？	条件不好啊,我就是说的别人	0
不，你们两个不是互相认识吗？	我和他不认识	0
是的，你还在上学还是在工作？	上学呢!你是哪个学校的？	0
是的，它总是让人发笑。你最近有什么问题吗？	没有啊，就是觉得自己不知道要什么。	0
我多大了？	你说啥?我信号不好	0
你一个人在哪里？	我在北京工作，现在在北京上班。	0
你知道我是哪里人吗？	不知道啊，你在哪个城市？	0
你不是在找吗？	是啊,都是没有啊	0
你知道我多大了吗？	知道啊,我也18	0
你结过几次婚？	一次都没结婚	0
你什么时候下班？	这个月底，下个月中旬吧!	1
是	你在哪上班呢？	0
你是哪里人？	我是河北人，现在在北京工作!	0
你什么时候去的公司？	我五点多去的,怎么了?	0
你好，我有一张音乐会的票。你不想去吗？	我想去呀!可是我没有票	0
你还在上学，还是已经毕业并工作了？	我还在读书，明年才毕业!	0
你什么时候起床的？	我是晚上9点左右,你现在有头晕的感觉么?我头晕	0
对嗯	你有孩子了？	0
对呀	我的也是一个月一次,但是我是一年一次	1
你是哪里人？	我是浙江人，现在在杭州工作!	0
我不喜欢模仿别人的东西，你经常看影视？	不是，只是偶尔看看。	0
你读《百年孤独》有多久了？	两年多了吧，断断续续的看。	0
瑜伽课上的阿姨多大了？	我也想知道她多大了!	0
是	哦,那你现在是在美国吗?	0
这位朋友来自哪里？	来自法国的一个朋友，他是法国人	0
你还在哪里？	我在北京呢,还没辞职呢	0
你知道我什么时候睡觉吗？	不知道,我又不是神	0
对，我的车辆刚走，你坐几路车辆啦？	我坐11路的，你在哪呢？	0
你好，我们能更深入地了解一下吗？	好啊，你说吧!	0
你知道我喜欢听什么样的书吗？	不知道,你告诉我吧	0
你学这个专业吗？	嗯是呀,怎么啦	0
你是正式劳作还是学习者兼职啊？	当然是学生了	0
什么意思？	就是你要来找我的意思啊!	0
谁在金融业？	我在啊,怎么了?	0
你会游泳吗？	废话,我可是会游泳的人	0
你什么时候进来的？	我也是刚进来的。你是做什么的？	0
！！	你有男朋友吗？	0
一个月挣多少钱？	4左右,够自己花就行,加盟开的不怎么费时间呀	0
上学要花多少钱？	学费加生活费一共6千左右	0
你知道我在哪家公司工作吗？	不知道,你说说啊	0
你住在哪里？	我住在五道口这里，离你远吗？	0
这对你来说并不容易。你父母是做什么的？	我父母是农民,我也是	0
我多大了？	这个,我不知道呀	0
嗨，你有感兴趣陪我聊会儿天吗？	当然有!	0
你喜欢谁的歌？	张杰，林俊杰，王力宏，张杰	0
诶呀	我都不知道该怎么回复了	0
你知道我喜欢谁吗？	不知道啊!你喜欢谁？	0
~	那你平时喜欢做什么呢?	0
唉唉唉	你知道我是谁吗？	0
这是正确的。你有爱好吗？	我爱好你	0
没错。你自己租房子吗？	对啊,你也是吗?在哪边租的房啊	0
~~	那你有想过以后孩子的教育吗	0
真好，大学过活是很精彩的，你一定交了很多友人吧？	没有，我只有一个死党。	0
嗨喽	嗨,你在干嘛呢	0
你不是在工作吗？	现在没在工作啊	0
这样啊，那你找到了有关于市场营销的劳作了吗？	我现在做的跟市场营销差不多,不过不是销售方面的	0
好哇	那我加你可以么?	0
你说得对。你不工作吗？	工作啊,我是自己做生意的	0
你知道谁是我最喜欢的音乐家吗？	是朗朗吗?	0
是的，你非常喜欢读书吗？	是的，我很喜欢	0
宿舍楼二楼是几号？	我不知道,当时我在二号楼	0
不错嘛，听样子你是每个周五都会回吗？	对,只要不下雨	0
。	哦哦,你以前是做哪方面的呢?	0
会计在一个月或一个季度的什么时候可以忙碌？	是的,现在就在做会计	0
你知道这葡萄有几种口味吗？	这我就不知道啦,就吃过这俩,你呢	0
那干你们行销的是不是都会有人经常辞职啊？	有很多都是,但是辞职的原因都是因为个人原因	0
你有几个孩子？	五个，还有两个女儿和一个儿子	1
你家有多少只猫？	我家有四只猫!还有一只是公的!	0
你最近读了谁的书？	东野圭璋的《白夜行》和《恶意》	0
你喜欢的歌叫什么名字？	我也不知道，我只是喜欢听歌而已	0
你好啊，你讨厌玩王者荣耀吗？	还好吧,就是觉得游戏没什么好玩的	0
你知道我上的课叫什么名字吗？	我不知道,反正我没上过	0
你知道我开始演戏的时候多大了吗？	你多大和我有什么关系吗?	0
。	你大学是学什么的?	0
你不是很喜欢看《泰坦尼克号》吗？	是啊!但是我更喜欢《阿甘正传!	0
他在预选赛中赢得了多少枚白金奖牌？	赢了三个,输了一个	0
你是在上学还是已经在劳作了？	我是在上班，你是做什么工作的？	0
我喜欢读谁的诗？	我怎么知道你,我又不认识你	0
你能每天都这样睡觉吗？	我不知道，我只知道我可以	0
你在几年级踢足球？	三年级，你呢？	0
咳咳咳	那我要叫你姐姐啦	0
你就是这么想的。这位老人退休了吗？	我不知道怎么跟你解释	0
嗯？	你喜欢看书吗？	0
嗨嗨嗨	你现在找到工作了么	0
唉	你要是有时间可以来我店里看看	0
是哦	你是做什么工作的？	0
你知道我有几个兄弟吗？	不知道，我只知道你有一个哥哥。	0
对呀，你也厌恶养宠物吗？	不厌恶呀,只是没有那么喜欢了而已	0
你早上什么时候才能起床？	6点多,7点多吧	0
我还没看过。我喜欢看周星驰的老电影。你喜欢吗？	很喜欢，很喜欢!	0
负责调查的人叫什么名字？	我不知道你问的是谁	0
呃呃	没事,我已经好了	0
通常什么时候睡觉？	晚上11点到2点之间	0
你养什么动物？	仓鼠，仓鼠是我的最爱!	0
哇，很好呀！那你是辩护律师吗？	我不是律师哦,你是不是想做辩护律师啊?	0
你知道我最喜欢的城市是什么吗？	不知道!	0
你父母是怎么教你这么好的？	他们教我什么了？	0
你好，我来自中国东北。你从哪里来的？	我从地球上来的呀	0
你知道她死的时候我多大吗？	我知道你多大了。	0
今天是星期几？	不知道,反正我不上班	0
是呀，对了，你是做什么劳作的呢？	人力资源啊!人力资源,不是劳作	0
你是演员吗？	是啊!你是男主角	0
好啊，你是做什么劳作的呀？	那挺好的呀,你可以加我微信,咱们一起交流经验,你的微信多少呢?	0
你叫什么名字？	你说你的名字,我看看我有没有认错	0
嗯对	那你喜欢我吗？	0
哦，在你的成长过程中发生了什么重要的事情吗？	是的，是的!	0
是的，我有一只狗。你呢？	你有狗,我没有	0
的确是大的太多了，那你是做什么劳作的？	我是做平面设计的，你在哪里呢？	0
你知道我现在在哪里工作吗？	不知道啊，你是山西人吗？	0
我吃的奶酪叫什么名字？	半熟芝士啊	0
啊	你有什么事吗？	0
你无聊的时候都会做些什么来打发日子？	看电影和睡觉	0
你要结婚了吗？	我结婚了啊,孩子都一岁半了啊	0
周末训练？	是啊，你不知道吗？	0
你知道我特别喜欢谁的作品吗？	不知道,难道是周杰伦?	0
你知道现在是哪一年吗？	不知道，我也不知道我几岁	0
这个问题的答案是什么？	什么问题,你说吧	0
你是哪里人？	我是浙江人，在上海工作!	0
是的，你非常喜欢冰淇淋吗？	是的，我很喜欢冰激凌。	0
嘁	你家是哪边的啊?	0
除了工作你在干什么？	就是每天上班,下班,睡觉	0
是啊我特别喜欢听她的歌，你有讨厌听的歌吗？	你的背包,听的我好难过	0
你喜欢的社团叫什么名字？	我喜欢相声,不是社团呀,	0
你知道另一个多大了吗？	不知道,但是知道你很牛逼	0
我是哪里人？	你不知道你家是哪里的?	0
你知道我多大了吗？	你不是说你三十多吗	0
这是你的特别喜好吗？	我的喜欢是你的喜好!	0
你不喜欢面条吗？	不喜欢!我喜欢面食!	1
你是什么人？	我是一个有故事的人!	0
你知道我通常什么时候喝啤酒吗？	你不说我怎么会知道,你又不告诉我	0
你知道我多大了吗？	不知道，你多大了？	0
你知道我多大了吗？	不知道,你说呗	0
他在加班所以没有出去，你都是一个人回健身房吗？	对啊，一个人在家练	1
我20岁是什么时候？	不知道,我只知道你20岁了	1
噢噢	有空可以过来玩的	0
啊，你不需要照顾孩子吗？	有妈在我放心	0
那你呢？你吃过了吗？	还没呢,还在上班,等会就去吃	0
你早上什么时候跑步，什么时候？	六点到六点半	0
看起来你也不喜欢猫？	不喜欢的话,就不会说喜欢猫	0
那你一定很开心吧？	嗯，很开心!	0
谢谢啊，你是小姐姐还是大哥哥啊？	好吧好吧,我是小姐姐咯	0
她不知道你要离婚了吗？	知道,我说的,她说离婚了,我就没法生活了	0
你和家人有这么多麻烦吗？	是的，太多麻烦了。	0
你多大了？	我今年本命年，比你大一岁。	0
你知道我16岁是什么时候吗？	你16岁时我还没有出生	0
嗯对	你家人知道吗？	0
对哦	那怎么还没适应呢	0
谁是最著名的明星？	没有最，只有更!	0
哦哦，这样啊，你是放工路上经过这里吗？	放工是什么	0
你什么时候下班？	我已经下班了，你呢？	0
在网上工作要花多少钱？	不知道你是怎么做的?我是加盟的比较方便不用进货	0
~~	是什么行业的销售?	0
我现在还是单身呢，你有女友吗？	没有，你要给我介绍吗？	0
你什么时候睡觉？	现在就睡,你也早点睡吧	0
呜	那你现在做什么工作呢?	0
你平时除了歌唱没有其他的爱好吗？	打篮球也是我的爱好	0
哇，非常强大。那你一定很文学。你写小说多久了？	文笔不好,写不出来	0
你什么时候在公司吃饭？	一般都是早上九点上班,我是九点到十点吃饭时间	0
你知道我儿子多大了吗？	不知道，你告诉我吧。	0
我友人也这样说，那你平时就干什么呢？	睡觉，看电视，玩游戏，看书	0
有时的，最近很苦恼，我跟你说说吧，你愿意听吗？	我愿意听,你说吧	0
对嘛	嗯嗯，是的，养了一个多月了	0
我喜欢哪个国家的动漫？	你是一个喜欢日本动漫的人	0
你在哪里工作？	我在上海,你呢	0
啊，你什么时候下班？	六点多吧,你呢	0
哈咯啊	哈咯是什么意思?	0
你竟然还玩滑板，你是一个在校生吗？	不是,我是校外的	0
你参加的课程叫什么名字？	我不知道，我只是个学生	0
你知道我妈妈几岁了吗？	几岁都不重要，重要的是你想要什么。	0
你喜欢读这样的书吗？	我觉得还不错,你呢	0
我们成了朋友。我们谈谈吧。你的爱好是什么？	我的爱好就是看书，听歌，看书!	0
你知道谁的歌很好吗？	我只听周杰伦的	0
汽车内饰的改进工作在哪里？	在厦门思明区	0
你知道什么是建筑设计师吗？	不知道。	0
你是哪里人？	我是河南洛阳的,可以交个朋友吗	0
你成年需要几个月？	我已经成年了，谢谢!	0
多大岁数？	比你大五岁吧!	0
你知道我最喜欢的节日是什么吗？	不知道!	0
周星驰的助手是谁？	吴孟达,周润发	0
你读过的书中有哪一本？	活着》是我看的第一本书。	0
达利在哪里？	就在昆明呀	0
你知道我是哪里人吗？	不知道啊，你是哪里的？	0
你是哪里人？	我是江苏的,我们这里有很多山东人	0
我六岁的时候？	你几岁了？	0
我出生在中国的哪个地区？	我只知道你是我老乡	0
那你的丈夫是做什么劳作的？	他是个医生，在医院工作。	0
你知道这本书中我特别喜欢谁吗？	谁？	0
哇	你叫什么名字？	0
你厌恶吃什么？	我讨厌吃鱼	0
我养了好多鱼儿，我家有个很漂亮的鱼缸，不说我了，你喜欢做什么？	钓鱼,吃鱼,钓完鱼之后吃鱼肉,吃完鱼肉再钓鱼	0
你知道我什么时候经常散步吗？	不知道啊,什么时候	0
你知道我多大了吗？	不知道啊!你多大了？	0
你知道我的猫死的时候多大了吗？	不知道!	0
你每天工作多少小时？	早上九点到下午六点半	0
你从没去过哪个国家？	美国,西班牙,法国,英国	0
你知道我多大了吗？	不知道,不过我知道你是一个老太婆	1
你好，我叫赵武。你叫什么名字？	我叫赵婷。你呢？有什么事吗？	0
你想上什么样的学校？	我也不知道，就是不知道	0
你有几个孩子？	两个，一个男孩，一个女孩。	0
你儿子在哪里？	在北京呢，你呢？	0
你知道我多大了吗？	不知道，我只知道你比我大	0
嗯嗯对	那你平时都看什么电影?	0
你一个月挣多少钱？	我做网,店,一月能挣,3,4,千吧	0
可以啦	我还没找到工作,现在还没有找到,我想找个包吃住的	0
你现在是学生了吗？	嗯,是的,今年大四	0
我能说多少种语言？	那你会什么语言呢？	0
我会努力的。你不喜欢夏天的烧烤吗？	喜欢啊!可是我不喜欢吃!	1
是	你在看什么电视？	0
你是做什么的？	我是搞设计的	0
服务员，你一定不会因为工作累吧？	我不知道，我还在想这个问题。	0
你工作这么闲的吗？	不闲,一天要做很多事,但是都是一件一件做完再做别的	0
你喜欢谁？	喜欢我自己可以吗?	0
当然你今年几岁？	我已经23岁了。	0
哦哦嗯	你是哪里人啊,我湖北的,现在在上海做销售	0
你多大了？	我比你大，我今年25了。	1
呗	你呢,是做什么的啊?	0
我听说川菜不太辣。你能忍受吗？	你听说的不太准哦	0
嘿嘿，你平时除了听歌你还讨厌做什么呢？	我不讨厌听歌，只是不喜欢听歌而已。	0
你现在不是有自己的工作了吗？	嗯,我是开微商店的	0
~~~	你在干嘛呢？	0
我还在上高中。你是做什么的？	我在上高中你是做什么的呀?	0
你不喜欢雨衣或玩具吗？	不喜欢!我喜欢穿雨衣的!	0
你在哪工作？	我在北京，你呢？	0
是的，你不去上学吗？	我已经毕业了呀,我都出来两年半了	0
嗯啊	是啊,我投了两次,都没反应	0
好的，强强。你现在在做什么？	我在一家培训机构做老师，你呢？还在读书吗？	0
你准备工作的城市在哪里？	就是广州啊	0
对啊，你讨厌野营和户外活动吗？	不讨厌，只是不喜欢而已!	0
你在网店一个月能挣多少元？	4左右吧,我不经常看手机的,都是用电脑,打理的,还不错吧	0
通常什么时候发生？	我一般都是下午去，有时候晚上也去。	0
你知道我什么时候继续跳舞吗？	不知道。	0
我有多少只猫？	你有很多只	0
这本书什么时候写完？	不知道，还没写完。	0
噢噢噢	你喜欢狗狗吗？	0
嘿，嘿，谢谢你的夸奖。你还在学校吗？	是的，还在呢!	0
是的，你呢？你是做什么的？	我在工地搬砖,你是哪里人?	0
我现在已经上班了呢，你还是个学习者吗？	是的，你在哪里上班呢？	0
清华大学在哪里？	在北京啊，你是哪个学校的？	0
很好。你上过大学吗？	好吧,大学毕业,现在在北京上班	0
在看小说书越来越睡不着，你玩什么呢？	我在看甄嬛传，越看越精神。	0
有空的时候我喜欢听歌曲和读小说。你没有什么爱好吗？	我喜欢读书，喜欢听音乐，喜欢看电影	0
你什么时候出生的？	哈哈,我是八八年的大叔	0
呃呃	我是刚出来实习的	0
我更喜欢哪家店？	我也不知道，我都没去过!	0
郑州在哪个省？	河南啊!你呢？在哪儿呢？	0
你家里有多少只猫？	两只，一只大的，一只小的	0
你爱喝白咖啡吗？	我不爱喝白的。	0
是因为你刚从空调房出来，室内外温差很大吗？	是的，外面很冷，屋里很热!	0
你要去哪里？	不知道,想去的地方好多	0
嗯嗯，你讨厌穿什么牌子的鞋子呢？	不喜欢穿帆布鞋。	0
你是怎么学这门课的？	我是理科生，我也不知道怎么学的。	0
你知道我喜欢去做什么吗？	看电影吗?	0
你知道一个人每天跑多少公里吗？	不知道，我一般都是一个人跑	0
那你平时讨厌看电视吗？	一般般,没什么感觉	0
你知道我母亲的国籍是什么吗？	不知道啊，你知道吗？	0
哦你都厌恶玩哪些电子游戏啊？	我不玩游戏的，只是偶尔会玩。	1
你为什么不去上班呢？	我也想啊，可是我没办法啊!	0
喝啊	不喝,我喝饮料	0
电影里的电影叫什么名字？	我没看过,不知道	0
你开餐饮店一年大概可以赚多少钱啊？	一年也就20万左右,不算房租	0
我不太明白你的意思。你指的是什么水？	自来水和矿泉水	0
你知道我什么时候才是成年人吗？	不知道,我只知道你爸妈肯定很辛苦	0
你知道我喜欢多少首歌吗？	我只知道你是杰迷,我也只听杰伦的歌	0
我会尽力的。你失业了吗？	我是人民教师,怎么会失业	0
那确实太让人难过了，你现在上学还是放工呢？	我现在在上班啦	0
你知道两天后我要去哪里吗？	不知道，你想去哪？	0
那你认为该吃点什么菜呢？	青椒炒鸡蛋，青椒肉丝，青椒炒肉丝。	0
哎哎哎	怎么了？	0
你上班时还有时间玩手机吗？	当然啦,我上班是玩电脑的	0
哦，你的工作可能很乏累吧？	不，还好，只是有点累而已。	0
你知道去年我被选为哪个队吗？	不知道。	0
听起来不错，但你不觉得很麻烦吗？	不麻烦啊，我喜欢一个人的生活。	0
我只是很惊讶。你今天没课吗？	有啊，现在就在上课啊!	0
是的，你会打篮球吗？	会一点点,我是菜鸟	0
嘁	你是怎么去的,有车吗?	0
是吧，对了你平时讨厌看恐怖小说吗？	一般,不讨厌	0
你多大了？	那也挺早就结婚了啊,我比你小,我92的	0
你知道谁是我最喜欢的歌手吗？	不知道!	0
下班后你通常什么时候来？	我通常都是这个点来。	0
哇啊	你也要注意身体啊,天气变化大,感冒了可不舒服	0
、	怎么了？	0
是的，你为什么难过？	因为我想要的太多了!	0
负责调查的人叫什么名字？	你问这个干嘛？	0
嘻嘻嘻	你是叫小珞吗?	0
你不做运动吗？	做啊,我的运动量比较大	0
老师很好。毕业后你不想在哪里工作？	没想好,我想先考教师资格证	0
你知道最大的猫多大了吗？	我这只就是最大的了,一岁多了	0
你在这座城市多久了？	我在这里有5年了吧!	0
嘻	哈哈,那我就不打扰你了	0
你知道我训练过多少种动物吗？	你能说说吗?	0
现在是个好孩子。你在家干什么？	我在看电视啊!你呢？	0
哪里有稳定的工作？	看你想不想做啊,想的话就找的到	0
你不喜欢哪个乐队？	我不喜欢的也解散了,你不知道?	0
这是正确的。你有爱好吗？	我也没爱好	0
你知道我多大了吗？	你都说了26了	0
那你会经常来野外采风吗？	会呀,这是我们自己的事	0
你训练的目的是什么？	我想让你知道我有多喜欢你!	0
我非常喜欢听说唱音乐。你呢？	我也是!	0
在超市劳作也不清闲呀，你怎么这么清闲呢？	我也不知道，可能是因为我比较闲吧!	0
你知道我是什么样的评论员吗？	不知道!	0
你来自哪个国家？	我来自遥远的大洋彼岸!	0
你不是很喜欢饺子吗？	是啊,所以我喜欢灌汤包	0
我最近几年没有重病。你是做什么的？	我在家呆了三年了,今年打算上班	0
你知道我最喜欢什么季节吗？	秋天吧，冬天太冷了!	0
你知道我喜欢哪个队吗？	湖人?	0
是啊，难道你不是一个未婚人士吗？	好吧,我是未婚人士	0
你知道我所在的军队叫什么名字吗？	中国人民解放军呗	0
那你挺会享受过活的吗？	你要我说实话吗,我不会享受	0
好的，你不忙吗？	不忙，等你来找我!	0
你通常喜欢出去吗？	我不喜欢，我很少出去。	0
看来你还是学员吧？	嗯呢,对啊,你是?	0
我也是。你现在在做什么？	没做什么,你什么时候回来?	0
全副武装，你要去哪里？	去你的心里,哈哈	0
你知道“docosa”的西班牙语单词是什么吗？	我不会西班牙语	0
你知道什么时候有日食吗？	我也不是很确定,只是有看到这个报道,你去搜一下看有没有相关报道	0
哦哦	你是哪里人？	0
你说你喜欢美食，山西你有啥自荐的吗？	我最喜欢吃的就是山西的面食了!	0
喂，你吃过饭了吗？	我还没吃啊,我要你喂	0
网店每月收费多少美元？	不多不多,也就四五千吧	0
你人不舒服吗？	人也还好,就是没力气	0
全副武装，你要去哪里？	你去吧!祝你好运	0
你知道我的猫叫什么名字吗？	不是敦敦吗?	0
对对	你好，我叫阿金，你的名字呢？	0
这么多花儿，你是开花店的吗？	不是啊,都是自己养的	0
你和朋友出去吗？	很少,基本在家里	0
啊哈哈	你是男的女的？	0
你现在是老师了，不是吗？	是的，老师。	0
不是我，是你。你最近在做什么？	我在找工作啊!你呢？	0
一个月挣多少钱？	那还行,能挣不少钱呢,我也想做个,就是自己不会	0
……	那就等有钱了去	0
像你这样的普通人如此自由？	我不是普通人，我只是一个普通的人!	1
你喜欢看中国嘻哈吗？	我喜欢看嘻哈，你呢？	0
那你是不是设计过很多服饰啊？	没有啊,只做过一个品牌	0
潍坊在哪个省？	山东省啊,你不是山东的吗	0
哇啊	你知道吗，我觉得你很可爱	0
安息日你几点上班？	九点上班,八点半下班,十点半睡觉	0
你在哪？	我在广州啊，你在哪个区？	0
你还有宠物吗？	有啊,一只仓鼠,还有一只乌龟	0
我多大了？	你都53了,还装嫩	0
我最近很开心。你知道为什么吗？	因为你是我的粉丝!	0
你知道我什么时候起床喂鸟，听鸟叫吗？	不知道,我是六点半喂	0
你知道我最喜欢的篮球队是什么吗？	不知道你说出来	0
你好，我也很高兴认识你。你是做什么的？	在网上做点生意	0
在大学肯定要夜宿，那你夜宿的东西都准备好了吗？	准备去买	0
你的家乡是什么？	我是四川的,现在在江苏	0
呦呵	怎么了?我是一个有内涵的人,哈哈	0
你知道我在哪里看到米老鼠的吗？	不知道!	0
哇呜	你不回家呀?	0
我喜欢看爱情小说，你看小说书吗？	你看我就看	0
什么的职员？	文案，策划，企划助理，都有。	0
是的，我经常在业余时间去健身房。健身真的让人上瘾。你不相信吗？	没有,我信,因为我也喜欢	0
唉，你真可怜。你有什么爱好吗？	我喜欢看书，看电影，看书，电影，电影	0
你现在上大学了吗？	是啊，我都毕业了，你呢	1
你知道我家的语言是什么吗？	我不是广东人,我不知道	0
噗	最近有什么开心的事吗	0
没关系。看一看，练习一下你的勇气。今天不是周末。你今天打算做什么？	你在问什么我有点看不懂	0
你去过多少地方？	不多,也有不少地方了	1
谢谢啊，你是小姐姐还是大哥哥啊？	哈哈,我是大哥哥	0
你必须尽力为你的伴侣加油。你住在学校吗？	不在,我们都不住校	0
你现在做什么？	还在做销售,我现在做电销	0
那挺好的啊，没事的时候可以看看山光水色，那你学的是什么专业啊？	我学的是电子商务,那你呢?	0
欸	你喜欢看什么书？	0
你看了什么鼓舞人心的电影？	我看的都是励志的，励志的都看过了	0
你知道我多大了吗？	不是十五吗	0
我居住的国家叫什么名字？	你是哪个国家的？	0
啊啊	那你们怎么打算的呢?	0
你知道我喜欢谁的音乐吗？	不知道，你说说看!	0
还行吧，你以前是怎么询问别人的？	我问他们为什么这么笨，他们说我太聪明了	1
更不用说了，你经常锻炼吗？	我天天都锻炼	0
是的，我想去很久了。你呢？	我也是啊,我去了两次啦,	0
你好，我遇到了一件事儿，我好难过呀，你能听我说说吗？	当然可以，你说吧!	0
你住在哪里？	我住在西直门这边，你呢	0
离上次有多少个月了？	5个多月了，怎么了？	0
你知道我喜欢什么样的食物吗？	不知道,反正我是吃货,什么都吃	0
我正在吃早餐。你吃了吗？	你这是早餐吗?午饭都吃了	0
你们劳作的时候还能看书，这么轻松吗？	这个就不清楚了，反正我是很轻松的!	0
姐儿你好，在干嘛？	在想怎么才能跟你成为好姐妹	0
早上好，你起得很早。你也早起做饭吗？	早上起的很早吗?你也很早,你也早起做饭吗?	0
你喜欢王一博吗？	还行吧!不讨厌也不喜欢!	0
哦，姐姐，你打算减肥还是塑形？	塑形吧，不知道有没有效果	0
养了多久了？	养了一年多了。	0
~~~	你是不是有什么事要跟我说啊？	0
你在哪个城市？	我在上海，你是做什么的？	0
你知道我喜欢什么样的食物吗？	你喜欢吃什么我怎么知道	0
别人捡到了什么？	有捡到一只流浪猫,有捡到几只小狗	0
你是做什么的？	我是做护肤品的,你呢	0
嘁	我也不知道我的名字怎么变成这个鬼了	0
啊啊	我也不知道,小时候也没问过我妈妈	0
你知道我是哪里人吗？	不知道啊,你说说吧	0
你知道我需要多少年才能退休吗？	是不是有年龄要求?我听说好像是35岁还是多少才能退休	0
那你真的很无聊。你有孩子吗？	我没有,我也不想有,我就是无聊,怎么地	0
你知道她带着她的狗跑了多久吗？	不知道!我只知道你家狗很厉害	0
我是哪里人？	你自己哪里的都不知道啊?	0
你知道我从事什么行业吗？	我是做会计培训的,你说我知道吗?	0
什么时候结束？	不知道啊，应该快了吧	0
看起来你也不喜欢猫？	喜欢,但是不喜欢养,因为养不好	0
你一天吃多少个馒头？	我也不知道,有时候多有时候少	0
是的，有电视版。你看到了吗？	看到了,但是感觉和电影没多大区别,还是小说好	0
你想去哪个国家？	没想好,但是不想去东南亚,你是哪里的?	0
…	嗯,你最近咋样?	0
大一是哪一年？	今年的,你呢?	0
我也非常喜欢肉。我不能整天吃。你喜欢什么肉？	鸡肉,牛肉,鱼肉,鸭肉,猪肉,羊肉,牛肉	0
那你都喜欢吃哪些食品呢？	我不挑食，只要好吃的都喜欢	0
你知道我最喜欢的乐队是什么吗？	我只知道他们的乐队叫五月天	0
你什么时候不上班？	我明天也不上班啊	0
对对	是的,我也是在那个人那里瘦下来的	0
我喜欢谁的声音？	林俊杰!	0
装修你的房子要花多少钱？	我还没装呢	0
欸	你喜欢什么样的生活呢？	0
我一个人住。你不想让大狗保护你吗？	想啊，可是我怕它咬我	0
会计在一个月或一个季度的什么时候可以忙碌？	我不是财务专业的,所以我不晓得	0
你也喜欢听音乐。你喜欢什么样的音乐？	只要好听,什么都喜欢	0
我还没去过内蒙古。你经常旅行吗？	我也没有去过内蒙,我经常出差	0
好的，你刚才在看什么体育比赛？	我在看尤文对尤文的比赛	1
你最喜欢哪个奥运会开幕式？	06的,不过08的也不错	0
你知道这对夫妇的女儿多大了吗？	不知道,只知道一个女儿	0
我同情你。你养什么狗？	我养的是泰迪,一个月前被偷了	0
你通常有减压的习惯吗？	没有，我喜欢一个人呆着	0
你所在的年级叫什么名字？	我已经毕业了，你是哪个学校的？	0
谁的歌特别有挑战性？	我唱的一般般	0
哦对	从基础练,从简单弹唱练起,然后就爬格子,练音阶,练习手指灵活度	0
你好，你用一种可爱的方式打招呼。你是做什么的？	哈哈,我是做外贸的,你呢?	0
你不玩什么游戏？	你说的我都不玩	0
好的，你没有什么爱好吗？	没有特别喜欢的事情,我喜欢看电影,看书,打台球	0
你开始写作有几个月了？	我是三月份开始写的	0
你好，你现在一个人吗？	是的，我一个人	0
那你工作真的很无聊。你是怎么得到这份工作的？	无聊吗?还好吧,我是在网上找到的	0
我在看电视，看的是《创造营2020》，你有看过这个剧目吗？	没有诶，我去找找看!	0
你知道我喜欢什么吗？	不知道,你说吧?	0
你是哪里人？	我是湖北人，现在在杭州工作!	0
你好，我们现在可以聊聊吗？	你好,我不可以	0
你花了多长时间才认识月季和山茶花？	月季是去年才开始种的,山茶花我也种了,也没几天	0
什么能让你这么难过？	不知道怎么说,你呢最近过得好么?	0
你好呀，你是毕业生还是女生呢？	我是女生，不过我是男的!	1
？	有点远,那就等有机会吧	0
恋爱时你在哪里？	在北京啊，恋爱的时候我就在北京。	0
你知道我什么时候喜欢骑自行车吗？	这个,不知道,你说说?	0
那你这些天都不能上班了，不是吗？	是的，所以我要走了。	0
你一月份挣了多少钱？	不太多,一个月也就八九千	0
你现在是做什么劳作呢？	我是做金融服务的,你在上海么?	0
你多大了？	我也18,我是安徽的,你呢?	0
你每天上几节课？	三门课,两节课一起上,一节课90分钟	0
我想出去旅行，你有什么好地区推荐嘛？	我也不知道，我也没去过	0
你知道我多大了吗？	不知道，你告诉我吧!	0
你来自哪个省？	广东啊，不知道你是哪个省的？	0
对嗯	对啊,我也没起来	0
你家有几条狗？	2只，都是公的。	0
...	好啊，那我们就做朋友吧!	0
你知道贵阳在哪里吗？	贵阳市啊	0
你多大了？	我25了，你呢？	0
你们俩都病了是真的吗？	嗯,病了好几年了	0
你现在住在哪里？	我住深圳这边,罗湖区	0
你知道我弟弟是哪个军种的吗？	你弟弟?我还不知道呢	0
它不容易。你将来不想当律师吗？	我不太感兴趣,我喜欢当医生	0
你喜欢她吗？	不喜欢,不讨厌	0
你知道我所在的树叫什么名字吗？	不知道，你告诉我吧!	0
你知道我有多少辆自行车吗？	有我多吗?	0
这首歌是谁写的？	我也不知道，只知道是他们的歌	0
？	在家里玩啊	0
我有几个孩子？	一个!	0
~~	那你现在的想法呢?有点想结婚吗?	0
你每年都旅游一次，是你工作的地方安排的，还是你自己休假来的呀？	我自己来的，工作地点是上海!	0
你上过多少次厕所？	三次吧,怎么了?	0
哎哎哎	我们六年级才开始有体育课	0
你知道和我在一起的人是几岁吗？	不知道，我不知道。	0
你要带多少人？	不多，一个就够了。	0
你学这个专业吗？	不是,我学的是会计电算化	0
这个人昏迷了几个月？	两个半月,	0
你弹吉他有多少年了？	小学6年级玩的,现在高中毕业了	0
你知道我多大了吗？	不知道,多大	0
你失业多久了？	我没失业,我的工作是我父亲给找的	0
看来你还是个经理？	不是，我是打杂的!	0
你是哪里人？	我是广州的，你呢？	0
当然你喜欢喝酒吗？	你怎么知道我喜欢啊?	0
你不在医院工作吗？	没有呢,还在读大学	0
好哦	嗯嗯,加油,我们一定会瘦到自己理想的体重的	0
红色也很好。你通常在家做什么？	也没什么事就做个网店生意也不好	0
喜欢啊，我很喜欢我的犬，你吃午饭了吗？	刚吃完!	0
自从服用避孕药以来，你瘦了多少公斤？	我没有吃药,我是吃的减肥药	0
那很好。这并不孤独。你是做什么的？	我是做财务的，你在哪个城市？	0
是的，我养了一只特别可爱的小狗，你讨厌小狗吗？	我讨厌我的狗	0
是的，我也在学校。你还习惯在麦当劳工作吗？	还好吧!不过还是很忙的!	0
你所在的班级叫什么名字？	我是4班的，你是几班的？	0
你打算什么时候做？	我打算明年呢	0
我喜欢读谁的诗？	仓央嘉措,纳兰性德	0
好的，我想问你，日语容易学吗？	挺容易的，只要你用心学。	0
你减掉了多少公斤？	不知道，反正没减下来	0
我喜欢什么电影？	你喜欢的我都喜欢	0
你在博物馆工作，喜欢读书，你有很多朋友？	是啊，我有很多好朋友。	0
我是郑州当地人，你也是吧？	是的，你在郑州哪个区？	0
啊？	你说的这些都是我平时的生活	0
我每天跑多少公里？	不知道，没数过。	0
你在哪里工作？	上海,静安区,陆家嘴	0
你好，想聊聊吗？	聊什么都可以，只要你不嫌我烦就好。	0
这么厉害，那你现在可能有时间看电影了吧？	你有什么好的推荐吗?	0
你所在的学校叫什么名字？	西安工业大学北方信息工程学院	0
你叔叔在商场推销火锅食材和底料，你讨厌吃火锅吗？	不讨厌，我很喜欢。	0
你见笑了，我还在上学呢，我没劳作，你是做什么劳作的呀？	我是做财务的，你在哪个城市？	0
咳	我是学美术的，你呢？	0
你有多少朋友？	朋友很多,交心的朋友没几个	0
你是哪里人？	我是广东人，现在在深圳!	0
你知道我讨厌什么季节吗？	我猜是夏天?	0
你知道我最喜欢的季节是什么吗？	难道是春天吗,我猜的,对吗?	0
你什么时候去上班？	我明天上班,后天休息	0
她有多少只猫？	不知道，应该有十几只吧!	0
你只去过哪个城市？	三亚和海口都去过，海口我还没去过呢	1
我喜欢逛街买服饰，最喜欢的牌是爱马仕，你呢？	我喜欢买衣服!	0
你在哪里卖蔬菜？	大润发附近，你呢	0
那很好。你是做什么的？	我是做销售的,不过之前也做过采购	0
你多大了？	哦,我比你大一岁呢	0
翻译这么好的劳作，你竟然丢了？	哎,我也不想丢啊,可是丢了就丢了,没办法啊	0
你知道一家上市公司的CEO有多少个孩子吗？	不知道啊,有几个	0
你能做到吗？	能,就是懒,懒得做,懒得吃	0
。。。	你有什么,我也什么都没有	0
你通常在一天的什么时候练习？	下午5点到7点	0
喜欢看淘宝的人叫什么名字？	额,这个嘛!不告诉你	0
你知道我一周在剧院演出几次吗？	这个还真不知道,不过我是学舞蹈的	0
你知道我什么时候跑步吗？	不知道!	0
如果你有时间，你想谈什么？	我想谈恋爱,哈哈	0
你是哪里人？	我是河北人，现在在北京工作!	0
你知道我什么时候一个人看吗？	不知道啊,我只知道我怕一个人	0
呸	你怎么知道我每天坐公交？	0
好的，谢谢。你对什么感兴趣？	我喜欢音乐，音乐是我的最爱!	0
可是你结婚后不就阻断你发展的路径了吗？	我不知道，我只知道我不想要孩子。	0
如果你遇到你敢吗？	我敢!但是我不喜欢你!	0
你知道我来自哪个部门吗？	不知道,我不是你们部门的,你可以告诉我呀,呵呵	0
嗨，今天这里是蓝色的。那里的天气怎么样？	阴天，阴天!	0
我什么时候吃？	你啥时候想吃了就吃!	0
~~	你多大了,我26了	0
那好吧，你们是全家人都搬到北京了吗？	没有,就我自己,我妈和我弟弟还在老家的	0
好的，你喜欢大家庭吗？	不太喜欢,因为太多人	0
你在做生意吗？	是啊，我在做餐饮，你呢？	0
你什么时候在公司吃饭？	中午啊,我们中午都是公司吃的	0
哼	嘿嘿,不过你可以自学呀,不难,	0
好哦	那你平时都做什么运动呢?	0
我也喜欢看篮球比赛。你看NBA吗？	不看，我喜欢看nba!	1
我能听你说话吗？	可以啊，只要你不嫌弃我的声音!	0
你知道我有几个孩子吗？	不知道。	0
你对这个星期天感兴趣吗？	不感兴趣,你感兴趣就行了	0
还是算了吧，我不太喜欢喝酒，我比较喜欢玩RPG电脑游戏，你呢，你讨厌游戏吗？	游戏我不怎么喜欢,我喜欢看电影	0
当你旅行时，你是独自一人还是有人陪伴？	我是一个人独自旅行。	0
是的，你这么晚才吃东西？	没胃口,不想吃	0
你打什么联赛？	没有,我玩的不多,一个月能玩几天,不经常玩的	0
我最喜欢川菜。你喜欢什么样的食物？	我不知道川菜有哪些好吃,我喜欢吃辣的	0
你是哪里人？	我是山西人,山西忻州人	0
你一天能挣多少钱？	那还可以呀,我能不能做啊?	0
你现在在哪里？	我在北京啊，你在哪儿呢？	0
你也是马拉松爱好者？	是的，我喜欢马拉松。	0
你能演奏什么乐器？	吉他，贝斯，吉他都会一点	0
你也喜欢听音乐吗？	嗯嗯!超喜欢的!	0
噢噢	你是做这个的啊?	0
看来你经常来这里。你不是佛教徒吗？	我是初学者，还在学习中。	0
那是一个很厉害的校园，你有把握吗？	没把握啊	0
诶呀	最近在看什么书？	0
你知道我什么时候能找到工作吗？	不知道，我也不知道!	0
你在里面看什么？	我在看你的头像!	0
你知道我有多少只猫吗？	一只猫一条狗	0
我什么时候大学毕业的？	你是哪年毕业的呢？	0
他一个月赚多少钱？	他啊,每月就三千多快四千吧	0
哦	怎么?过得不好?	0
是的，我认为努力工作一定会有回报的。你刚下班吗？	我也刚洗完,躺在床上了,准备睡觉了,晚安	0
你不拍什么样的照片？	风景,人像,静物	0
天哪，你的专业是什么？	会计啊。你呢？也是会计专业吗？	0
啊啊	你是医生吗？	0
你什么时候开始工作？	下周三开始，不过我还没找到工作!	1
肖的昵称是什么？	肖恩雷德克	0
你知道我什么时候交第一个女朋友的吗？	你都毕业一年了,不交也该交了吧	0
啊哈哈	你喜欢吃什么？	0
你什么时候去上班？	明天上午去，下午就可以走了!	0
我也很高兴。你通常喜欢做什么？	看书,玩,唱歌,跳舞都喜欢	0
我什么时候大学毕业的？	我是用减肥药瘦的	0
那你现在从事的是什么劳作呀？	以前是行政，现在是财务。	0
哦，除了每天做家务，你还做什么？	看电视，看电影，看书，听音乐。	0
因为他很棒。你最不喜欢哪个主持人？	都不怎么了解,所以不怎么讨厌哪个主持人,你呢	0
你知道我生的第一个孩子叫什么名字吗？	不知道,是双胞胎,好羡慕	0
小组里有多少人？	有一个组,我也不知道多少人,我只加了一个,你可以加进来	0
你知道北京人的称呼是什么吗？	不知道。	0
他在哪里？	杭州啊，他在杭州工作，我在上海工作。	0
好	你也喜欢吗?我还没吃过	1
对嗯	我做的是电子商务方面的	0
当然你喜欢喝酒吗？	我是真的不喝酒,也不抽烟	0
嗯呐	我养的就是鳄龟，现在已经长大了	0
是的，爱是美丽的。你没有恋爱，但是？	但是我有喜欢的人了	0
对了	你是哪个学校的？	0
你什么时候去的公司？	我两点半左右到的公司	0
这个生物多大了？	刚生下来就死了,没生出来就已经死啦	1
我也很高兴和你们分享我生活中的乐趣。我现在住在重庆。你呢？	我也在重庆，你在哪个区？	0
郑州在哪个省？	郑州在河南，河南的省会是郑州!	0
我刚打完篮球。你不是舞者吗？	是,不过我是学民舞的	0
嗯嗯嗯	你是做什么工作的啊？	0
没错。高中毕业后，你打算去哪里上大学？	不知道呢，还没定下来呢!	0
然后努力学习。你的专业是什么？	我是学计算机科学与技术的，你呢？	0
你要等多久？	等到他回来	0
是	那你有写关于哪方面的呢	0
她有多少只猫？	不知道啊，应该有几千只吧!	0
你知道我还喜欢哪个乐队吗？	你说出来我就知道了	0
这个生物多大了？	什么生物	0
你叫什么名字？	我叫王小凤，是这里的常客!	0
你很讨厌看漫画啊？	不是啊!只是没有时间!我喜欢电视剧	0
你的家族是什么种族？	我的家族？我也不知道啊!	0
玩游戏，你呢？	我也在玩游戏	0
到了吗？	到啦到啦,今天到的	0
你知道我妈妈说什么语言吗？	不知道啊!	0
上帝，你的家人不能允许你表演吗？	当然同意,我家人很开明的	0
你知道我喜欢谁的音乐吗？	不知道,你是谁的迷弟?	0
你商店的月收入是多少？	你是怎么做的?给个扣教教我吧!我也想做	0
那你都是卖什么脂粉的呢？	我没买过脂粉呀,你有没有听过安利,我朋友卖这个,所以我知道这个	0
天哪，你和老板在一起是因为钱吗？	我和他不是钱的问题,我是为了和他在一起才努力	0
你知道谁是反战歌手吗？	不知道!	0
你来自哪个城市？	广州啊，你在哪个区？	0
不，我是中国人。你从哪里来的？	我是从四川来的，你也是吗？	0
好的哈，你喜欢哪款的车子？	我喜欢法拉利!	0
小霞的名字叫什么？	叫我晓霞吧	0
我还以为你还在学校呢。你是做什么的？	我是做广告策划的，你呢	0
那你是不是要来实习啊？	我就在医院啊,已经开始实习了	0
对嘛	嗯嗯,对嘛,所以我不喜欢,也不讨厌	0
你醒来的时候是什么时候？	六点多吧，我还没起呢	0
那么，你不应该加班吗？	我不是加班的人	0
你知道我教几年级吗？	不知道。	0
哎呦	怎么了？	0
你是怎么学习的？	我也不知道啊，就是每天都看书，就这样了	0
呵呵，我还以为是洋人呢，我是广州的，你是哪里的呢？	我在广州读书，你在哪个城市？	0
要完成多少工作？	还不知道呢!	0
你知道我有几个孩子吗？	我不知道,但是看了你写的,感觉你是一个有故事的妈妈	0
服务行业就是这样，同行业特色嘛，那你是做什么的呀？	哦,是的嘛,人力资源这块也比较好做一点的呀	0
当然，我每天游泳几个小时。你每天游泳吗？	我不喜欢游泳，我喜欢自由泳!	1
我教了多少年？	不知道，反正你教了我很多年	0
嘻	你是学油画的吗？	0
嘤嘤嘤	你想看什么电影，我可以陪你去。	0
好啊，你是做什么劳作的的啊？	我就是在办公室做点事,你呢?	0
你知道最近的餐馆在哪里吗？	不知道啊,你知道吗?	0
你以后去哪里？	我还不知道呢,去哪里不重要,重要的是你在哪里	0
你不是经常自己做饭吗？	那你是怎么自己做饭的?	0
你最喜欢哪个队？	米兰，因为我喜欢的人是米兰的球迷!	0
那也是为你好啊，有女友吗？	没有，有也不会介绍给你的!	0
你怎么能这样说话？你通常喜欢聊天吗？	是啊,我喜欢和美女聊天,尤其是你这样的美女,哈哈	0
那你为什么不把它绑起来？你不能把它分开吗？	他是被我逼着绑的,我也有点不想绑	0
你从哪个方向来？	我从东北的南边来，你呢？	0
你养的那条狗叫什么名字？	叫小六	0
生活是为了多少人？	我是为了父母	0
噢噢	你是女生,你也会这样吗	0
然后我有机会再听一遍。别这么说。你是做什么的？	我是做销售的，现在在一家外贸公司上班!	0
你多大了？	我是89年的，比你大一岁!	0
和你聊天要花多少钱？	我这人很好说话的,你看着给	0
你是哪里人？	我是辽宁鞍山的	0
我每天什么时候上班？	八点半啊	0
我在看影片，你喜欢听那个明星的歌曲？	陈奕迅!	0
我非常喜欢跳舞，你是做什么劳作的？	我是一个演员，你呢？	0
你知道谁的电影最受欢迎吗？	不知道。	0
你多大了？	我比你大几岁而已	0
你很厌恶写作吗？	嗯,感觉没有耐心,写不出什么东西	0
我是司机。你呢？	我是乘客，我也是司机!	1
这不是一本小说吗？你非常喜欢看小说吗？	是的，我很喜欢!	0
嘻	嘻什么啊,无聊死	0
好啊，你是做什么劳作的的啊？	我是生产汽车轮胎的哦	0
啊，回那里干嘛呀？	回去找你聊天呀!	0
好！	那你现在在做什么工作呢？	0
负责调查的人叫什么名字？	我不知道，我只知道他叫小亮。	1
我看的成龙的电影，你厌烦看成龙的电影吗？	怎么可能,他的电影我百看不厌	0
位于马绍尔群岛的岛屿叫什么名字？	鳌山岛	0
除了新疆，我更喜欢在哪里吃羊肉？	你在哪里？我带你去吃!	0
她有多少只猫？	一只公的，一只母的!	0
哇，太棒了。我也喜欢。我们找个时间出去吧。你开车，我带我的狗，好吗？	你也不会开车?	0
那你一定对爱情充满幻想了吧？	当然啦,人总要有希望,哈哈	0
不错不错，那你还喜欢干别的事吗，在闲的无聊的时候？	不喜欢了，我喜欢睡觉。	0
你早餐吃什么？	早餐不吃,吃了对身体不好,早餐我就吃了点燕麦片,喝了一杯黑咖啡	0
我看你全身上下都是红色的，头发都是红色的，你很讨厌红色吗？	我不讨厌红色	0
呦呦呦	你是我的优乐美啊	0
是嘛，真巧啊，那你现在退出工作了吗？	没有，还在读书呢!	0
你什么时候开始工作？	我还不知道，应该快了吧!	0
嘿，嘿，我能问一下你平时喜欢吃什么吗？	我可以说我什么都喜欢吃嘛,哈哈	0
你这么认为吗？	我这么认为啊,不知道别人,你是不是	0
你最厌烦干什么呀？	最厌烦的就是吃了睡睡了吃!	0
哦呦	我请你吃火锅你请我喝奶茶好不好	0
你为什么不能发表一篇文章？	我能发表啊,我说的是别人	0
哇哦，我很少看电视，你能具体给我讲一些好笑的事吗？	你就直接看这个节目就好了	0
什么时候结束？	下个月中旬吧，你呢？	0
你能这样工作吗？	当然，我的工作很简单。	0
你知道我还喜欢哪个乐队吗？	我不知道啊,你告诉我	0
还是算了吧，我不太喜欢喝酒，我比较喜欢玩RPG电脑游戏，你呢，你讨厌游戏吗？	我讨厌玩游戏,但我想试试你说的这个	0
谁是传奇人物？	甄嬛传里的女主角啊!	0
你通常在一天的什么时候练习？	上午和下午	0
你减掉了多少公斤？	一个月瘦了4斤，还有5斤没减	0
是的，但是你确定你想学这么多吗？	我可以先从最基础的学	0
你也很喜欢网络购啊？	我也喜欢网购,就是没时间,我喜欢网购的感觉	0
还是你更有洞察力？你是做什么的？	哦哦,你的工作应该不错吧,我就一上班族呢	0
你知道谁是我的偶像吗？	我不知道，你告诉我吧!	0
嘻	我也没结婚,哈哈哈	0
？	辞职啦,回家休息	0
谁的相声很好？	郭德纲啊	0
你工作多久了？	一年多了吧，我是今年刚毕业的。	1
你现在没有工作吗？	我现在还没毕业呢	0
你读《百年孤独》有多久了？	很久了，断断续续的看了好几遍	0
我听说川菜不太辣。你能忍受吗？	还好,我不吃辣	0
这对夫妇有几个孩子？	就1个啊	0
汽车内饰的改进工作在哪里？	在厦门呢,有什么问题吗?	0
我只是很惊讶。你今天没课吗？	有啊，我下课了，你在哪？	0
你在哪里工作？	我在北京，你在哪儿呢？	0
我最喜欢的季节是什么？	冬天!因为可以穿好多好看的衣服!	0
你知道我在哪里学骑马的吗？	不知道,不过应该是草原上吧	0
你知道顾客通常什么时候有空吗？	这个不知道，我不是做设计的。	0
你还有很多空闲时间。你是做什么的？	我是上班族还兼,职做了个,网,店	0
不，你们两个不是互相认识吗？	不,他跟我一个朋友在一起了	0
开车需要多少天？	两天,最多三天	0
那你为什么不做你想做的事呢？	我想要的是什么呢？	0
好吧，你没有去母校上课啊？	没有啊，我还在学校呢!	1
你不喜欢什么类型的电影？	不喜欢韩国电影	0
你是不是年龄小了？	你多大？	0
你来自哪个省？	安徽省的,你呢	0
嗯嗯	哦,那你的工作应该很好吧	0
我已经吃过了。你还没吃东西吗？	没有，我在等你一起吃呢!	0
哦，除了每天做家务，你还做什么？	我也不知道，反正就是没事做。	0
周申的歌很难模仿。你唱他的歌。你会唱吗？	我会唱，只是不在调上而已	0
有多少人？	这个就不知道了，我一般一个人	0
！！	我都快忘记我写过什么了,哈哈	0
我什么时候才能出类拔萃？	你已经很优秀了!	0
一周中哪一天你没有安排？	没有啊，我都是自己安排的!	1
嘿嘿，你平时除了听歌你还讨厌做什么呢？	我讨厌听歌，我喜欢一个人安静的听音乐。	1
你什么时候做了一件重要的事？	今天早上，我在你家楼下等你!	0
你什么时候要工作？	我一直在上班啊	0
谁是个好歌手？	我喜欢他的,夜色,还有,一个人的北京	0
你是哪里人？	你管我哪里人	0
噢噢噢	你呢？在哪里工作？	0
哦，你一定在忙你的工作吧？	是的，我在忙我的工作。	0
真是巧合。我也在听歌曲。你不听什么风格的歌？	我什么歌都听,没有什么具体风格,好听就行	0
哦哦，那你是很讨厌看书吗？	不讨厌，只是不喜欢。	0
你知道什么时候写的吗？	不知道诶,但是我想看,带我看吧,姐姐	0
我也喜欢唱歌啊，你厌烦谁的歌呢？	五月天，孙燕姿，五月天的歌我都喜欢	1
哦，你不写小说怎么办？	不知道诶,应该会找其他的事情代替吧,我也不是经常不写啊	0
我在哪里长大的？	现在在山西	0
啦啦啦	那你对什么感兴趣?	0
道郎的歌叫什么名字？	我也不知道,我也喜欢刀郎	0
我一听说你喜欢购物，我猜你是个女孩？	对啊,我也没说我喜欢逛,只是偶尔逛	0
你知道我什么时候值班吗？	你不是说这周值班吗,这周不是周日吗	0
你的劳作放假时日很长吗？	很长,一个月	0
你有几个姐妹？	两个姐姐，一个妹妹。	0
你知道我上的课叫什么名字吗？	不知道,我是学渣	0
好啊，你是做什么劳作的呀？	我是给老板打下手的	0
你知道我什么时候记忆力好吗？	早上吧,我早上记忆力也还可以	0
你不是在冲浪吗？	是啊在冲呢,怎么啦	0
呦呦呦	你喜欢哪个球星？	0
你现在在哪里？	我在北京啊，你在哪儿呢？	0
你没看过扣篮吗？	看过,你说那个人我不认识	0
负责调查的人叫什么名字？	我叫张翔，这个名字是我起的。	0
你想去哪个国家？	欧洲,或者澳大利亚,你呢	0
我也想去杭州。我将来会去那里一次。你是做什么的？	我是做室内设计的。	0
你好，我们能更深入地了解一下吗？	可以啊!你是男的还是女的？	0
你不喜欢什么类型的电影？	恐怖,血腥,血腥暴力的,还有恶心的	0
这孩子多大了？	一岁半了，已经是个大孩子了!	0
是的，你没有家人吗？	你多大了,我都没成家呢,我家人都不知道我的情况	0
我现在在一家商场做收银员，那你是做什么劳作呢？	设计狗一枚	0
当然你是做什么的？	我也是的,不过我现在在做微商了,感觉还不错	0
你知道一个家庭外出就餐需要支付多少钱吗？	不知道，没去过!	0
嘻嘻嘻	你叫什么名字？	0
你一周几点在家？	我一般都是8点到9点之间在家。	0
你多大了？	我今年刚满十八岁。	0
你知道我最喜欢的饮料是什么吗？	不知道!	0
这是必要的。顺便问一下，你是做什么的？	我是做室内装修的	0
嗬	她喜欢的东西我都会给她买!	0
不，你在动物园工作吗？	我是饲养员啊!	0
你好，你在画画吗？	是的，我在画画，你呢？	0
你好，你好！你在忙什么？	我在忙着跟你聊天。	0
你不忙吗？	我在家看孩子,你忙什么呢	0
你知道我多大了吗？	你都说了四岁	0
我喜欢在业余时间读小说书，尤其是窃密问题的小说书，我觉得这类的小说书很好看，还有就是我会在业余时间打网球，你呢？	我不喜欢,我喜欢有内涵的	0
你最喜欢什么样的时节呀？	春天和秋天	0
你知道我多大了吗？	不知道,你说嘛	0
你知道我多大了吗？	不知道，我只知道你比我大。	1
喏	那你还不加我,等什么	0
你儿子怎么了？	我儿子很好，他很好!	0
你喜欢谁？	我喜欢张惠妹,你信么?	0
呦	哦，那你知道我是干什么的吗？	0
你知道我什么时候去看望父母吗？	每个周末去看父母,那你什么时候回你父母身边?	0
那还真是辛苦啊，你们周末做事吗？	周末不做啊,就是平常的工作	0
你知道我养的那条狗叫谁吗？	我怎么会知道?你又不告诉我?	0
电影里的电影叫什么名字？	迪士尼是一个公司,海绵宝宝就是他出的	0
姐儿你好，在干嘛？	姐姐在看电视	0
你知道我在宿舍看了什么电影吗？	不知道,说说看	0
你是一个学生吗？	是的，你是学生？	0
女人的年龄是多少？	我是男的，你是女的？	0
你也是司机吗？	我是司机，你是乘客吗？	0
有一个宝贝，你今天没有放工吗？	没有,我们都不放工的,只有周日放假一天	1
你喜欢什么样的电脑游戏？	就是你说的这些,还有就是英雄三国这种,大型的	0
唉	你想考什么大学呢?	0
我来自河南。你从哪里来的？	河南南阳的，你也是吗？	0
哦哦	你在哪个城市？	0
你是女人？	我是女的!	0
我的家人是什么国籍？	这个我也不知道。	0
你好，我是一个投资分析师，你是做什么劳作的？	我是做技术分析的，你在哪个城市？	0
喂，你吃过饭了吗？	没吃!我不吃	0
你喜欢哪个国家？	我不知道,因为我没去过	0
你知道我讨厌什么样的天气吗？	夏天的雨,冬天的雪	0
你好，你可以不说话吗？	我不说话,你自言自语啊	0
你在哪个区？	雁塔区啊?难道不是?	0
你知道我多大了吗？	不知道，你说吧!	0
谢谢你的建议。你从哪里回来的？	我从上海回来的	0
你喜欢摇滚乐？	喜欢,但是没听过	0
呐	我在你对面，你来找我吧!	0
你不想练习吗？	不是不想,是没时间去练习啊	0
好的，你有什么爱好吗？	我喜欢一个人看电影!	0
我一直都不知道你们画师是靠什么挣钱的啊？	我们是卖画的	0
你可以去哪个城市？	都可以啊,你在哪个城市,我在湖南,离得好远的说	0
好！	你是哪里人啊？	0
大三学生的职称是什么？	没职称,只是学生而已	0
我也是哎，那你怎么不找男友啊？	我有男朋友了啊	0
我会的。你结束国内旅行了吗？	还没有呢，下个月回去。	0
你知道我喜欢什么乐队吗？	不知道!	0
你没吃午饭吗？	吃了一点不多	0
你知道最大的猫多大了吗？	我在上海啊,我不知道啊	0
你知道我什么时候去健身房吗？	不知道，我也想去	0
我开始玩的时候多大了？	不知道,反正比我小	0
我能和你谈谈吗？	我是个女的,我有一个孩子,想离婚,但是孩子不到两个月	0
呃呃	我喜欢看喜剧,恐怖片	0
慢跑者通常什么时候去？	晚上7点到8点之间。	0
你一定要上课吗？	我也不想啊,可是学校规定	0
你怎么知道水很冷？你下水了吗？	我在岸边，你在哪里？	0
是的，你想谈什么？	我不知道，我只知道你是个好人	0
我刚下班。你做了什么甜点？	我做了三种，你喜欢哪一种呢？	0
《工夫煮雨水》你听过吗？	没有我听听看	0
是的，除了注意健康，你没有什么爱好吗？	没有什么特别喜欢的爱好,你呢?平时喜欢做什么?	0
然后呢	然后?然后我就在国外了啊	0
你在哪里能买到房子？	上海啊，我家就在上海啊	0
你知道一天中什么时间是兼职工作吗？	不知道，我只知道每个月的第一个周末都是	0
你知道谁是我最喜欢的歌手吗？	不知道,不过现在知道了	1
一个人一个月挣多少钱？	网,店,一个月收入多少啊?	0
你现在还在和你妈妈做手工艺品吗？	嗯,是的,她现在还在做,做了好多年了	0
谁说不行？讨厌，你需要工作吗？	我在家呆的都快发霉了	0
谁和我在一起？	不知道,没注意看,只看到了陈教练	1
在金融行业，我毕业后就做过这件事。已经很多年了。你不能好好工作吗？	我不是不好好工作,我有好好工作啊,只是我没有去证券公司	0
嘿，嘿，我能问一下你平时喜欢吃什么吗？	我最喜欢吃辣条	0
你看过很多集吗？	嗯,看了很多集	0
你知道我最喜欢什么季节吗？	我不知道，我只知道我喜欢夏天!	0
那你空暇日子都做什么呢？	自己平时做个小店生意什么的,一月四五千	0
你要来卖什么东西呀？	我去买东西,不卖东西,我不是做生意的	0
你和父母住在一起吗？	不在,我跟我弟弟	0
你坚强的保证是什么？	没什么,只是觉得我能挺过来	0
负责调查的人叫什么名字？	我也不知道，我也是刚来的!	0
你见过漂泊的地球吗？	见过，我小时候住在这个星球上	0
我什么时候才是成年人？	你还小，等你长大了就知道了!	0
你不反驳吗？	反驳什么？我不知道啊!	0
多大岁数？	我91年的，今年刚好25岁!	0
你知道我通常什么时候喜欢散步吗？	不知道啊,你喜欢什么时候?	0
你多大了？	我今年24岁了，比你大一点。	0
你知道我喜欢谁的音乐吗？	不知道，我只知道你喜欢我	0
你想上哪所大学？	我想上厦大，因为我喜欢的人在那里	0
我喜欢广交朋友，你的爱好是什么？	我喜欢看书，你呢？	0
你知道我多大了吗？	你不是说你16岁嘛?	0
什么时候结束？	下个月20号左右吧	0
你知道我是哪个队的吗？	不知道，我只知道你很厉害!	0
你准备工作的城市在哪里？	广州天河区那边	0
你去过海南吗？	没有,但是想去看看	0
。	哦,那现在做什么?	0
你在哪里？	嗯,在北京呢,你呢	0
学校什么时候上课？	下午5点到6点，你来了就知道了	0
喔	你是哪的,你也在做生意吗	0
我真的很想成为你的朋友。我想和你一起玩，好吗？	好的,那你加我吧,你是什么段位,我看看我能不能和你玩一块	0
哪个国家有才艺表演？	我不看综艺节目的	0
！！！	你这是在调戏我?	0
你的孩子多大了？	一周八个月	0
我很喜欢看喜剧，你讨厌看什么类型的电视剧呢？	我讨厌看古装剧,因为我觉得有点假,看不进去,我喜欢看美剧	0
啊？	我是学护理的，现在在一家医院当护士。	0
？	有很多东西我都很喜欢,但是最喜欢的却很少	0
瑜伽课上的阿姨多大了？	不知道，没问!	0
你要回医院吗？	不回,但是我妈不在医院我不敢自己去	1
不觉得呀，我对做饭还挺感兴趣的，你厌恶做饭吗？	我不讨厌做饭，只是不喜欢做而已!	0
你知道我多大了吗？	你不说快26了么	0
你好呀，你平时厌烦游泳吗？	不厌烦啊,游泳很好的啊	0
在家购物要多少钱？	不多啊,就几千块钱啊	0
你知道谁是我最喜欢的艺术家吗？	不知道啊!是谁啊?	0
呦	你在哪里上班呀?	0
你知道出差需要多长时间吗？	不知道，我还没去过呢!	0
那你都是怎么打发日子的呀？	我也不知道,反正时间过得好快	0
你知道我是哪里人吗？	不知道啊!你是山东哪里的？	0
嘻哈	嗯,你是做什么的呀	0
第一次发生花了多少个月？	不记得了，反正是花了不少钱	0
你不是恋爱了吗？	是啊，可是我不想谈恋爱啊!	0
嘛	喜欢看书的人,都是好人	0
你知道我多大了吗？	知道,你跟我妈是同学	0
你知道我不认识哪个著名的作曲家吗？	不知道啊,我是小白	0
我在医院当档案管理员。你平时忙吗？	忙啊，忙着忙着就忘了忙了。	0
那你厌恶吃什么食物呢？	不挑食，只要是我喜欢的!	0
你喜欢沙拉，所以你应该喜欢健身？	我不喜欢，我只喜欢吃。	0
非常感谢。你通常喜欢做什么？	我喜欢发呆，发呆可以让我忘记烦恼。	0
~~	你喜欢吃什么？	0
你怎么知道我会做饭？	因为我是你肚子里的蛔虫!	0
嗯呐	你呢?怎么还不睡?	0
你最不喜欢哪个队？	米兰，因为我是米兰的球迷!	1
太棒了你没有什么爱好吗？	太广泛了,说不出个所以然来	0
我也挺喜欢我的劳作的，你是做什么的？	我是做平面设计的，你在哪个城市？	0
你明天什么时候走？	下午5点左右，你呢？	0
你知道我有几个女儿吗？	不知道，我只知道你有两个儿子。	0
我友人也这样说，那你平时就干什么呢？	看书，听歌，看电视，睡觉，打豆豆	0
嗯嗯，你最讨厌的小说是哪篇啊？	没有讨厌的吧,都挺不错的,都是我的小说啊	0
你知道高中的开始是什么吗？	不知道!	0
你知道我休息几天吗？	不知道啊,你自己说呗,我就说我想多休息休息	0
你多大了？	我比你大，你几岁了？	0
你喜欢艺术吗？	我喜欢音乐，你呢？	0
你没有和友朋逛过街吗？	没有,不喜欢逛街	0
你知道我多大了吗？	我猜你20多了	0
你喜欢什么样的天气？	我喜欢春天，夏天太热了	0
嗯嗯，你教的是哪门语言呀？	西班牙文，我是英语专业毕业的。	0
那你一定有很多肌肉吧？	没有，只有肥肉。	0
和你在同一栋楼演奏的乐队叫什么名字？	我不知道诶,我是在二楼听到的好像不是一个乐队,	0
你弹吉他有多少年了？	我弹了7年	0
哦，不，我把我的朋友带来了。他有一些睡眠问题，正在室内治疗。你也有睡眠问题吗？	是的，是的，非常有!	0
多少年了？	快五年了，你现在在做什么工作？	0
原来是这样啊，那你工作可能挺忙的吧？	还好，不算太忙!	0
嘿嘿对	我是学建筑工程的	0
那么，祝福你！你离开多久了？	快一年了，我离开的时候他还在上学。	0
你知道我忘了谁吗？	难道是李晨?	0
你在哪里工作？	我在闵行工作,靠近莘庄,你要来吗?	0
你好有爱心啊，但你平常有工夫照顾啊？	我不忙的时候，他们也会照顾的!	0
好	这就是我的生活	0
嗷	你还记得当年大明湖畔的容嬷嬷吗	0
你知道我最喜欢的乐队是什么吗？	不知道!	0
你要去看动物吗？	是啊，你要来吗？	0
这本书什么时候写完？	这本书还没写完呢!	0
你知道我叫什么名字吗？	你叫姜昕	0
上帝，我真的祝福你。你很开心吗？	对,非常开心	0
可以啊	网店好开吗?	0
他有几个女儿？	他有三个女儿，其中一个是我的女儿!	0
坏啊！你最近厌烦干什么？	最近,没烦的事,就是工作忙不过来,每天都好忙	0
所以你要改变你的观点？	我不知道怎么改变，我也不知道该怎么做	0
咯	你要去吗?我在找人和我一起去	0
你知道青岛啤酒产于哪个城市吗？	应该是青岛的啤酒厂吧!	0
对啊	那你还不睡啊？	0
四川菜有回锅肉、麻婆豆腐、辣子鸡，都是很美味的菜肴呢，那你厌恶的食物是什么呢？	除了香菜，其他都不喜欢!	0
你知道我认为谁的音乐能把我带到这个世界上来吗？	不知道，我只知道我喜欢的人	0
我现在在一家咖啡店做咖啡茶，你是做什么的啊？	我是咖啡师	0
我在哪里长大的？	铁岭呀	0
你擅长什么？	我什么都不擅长呢	0
饺子在我们哪个地方很常见？	不知道，反正我不喜欢吃	0
没关系。你失业多久了？	有两个多月了	0
你通常什么时候在家睡觉？	我一般都是晚上睡觉，白天睡觉!	1
你以前有工作经验吗？	有啊，怎么了？	0
我喜欢广交朋友，你的爱好是什么？	我的兴趣就是和你聊天啊!	0
你知道3号床的儿子的病房号是多少吗？	我不知道,你知道嘛?告诉我一下,谢谢你啦	0
你知道我儿子多大了吗？	不知道,难道很大了?	0
哇哇哇	你也喜欢看电影吗？	0
是的，你玩过腾讯的逗逗乐乐吗？	腾讯的,我玩过	0
你每次骑多长时间？	我一般骑半小时就可以了。	0
你知道最小的女儿多大了吗？	我不知道,应该有十几岁了吧	0
你知道我现在开的车是什么吗？	不知道啊，你告诉我呗	0
你经常卖彩票吗？	不常，只是偶尔!	0
咳咳咳	你是哪个学校的,我也大三,也是独生女	0
你有多少腹肌？	六块啊	0
你在哪里学的？	北京京彩,你可以去京彩看看	0
你知道我有几个孩子吗？	两个,一儿一女?	0
我最喜欢的季节是什么？	冬天!夏天太热了!	0
你多大了？	我是90年的，你呢？	0
你通常读什么样的书？	最近在读《明朝那些事儿》	0
你知道我是哪个队的运动员吗？	不知道,你说吧!我听	0
电影《七角》里的数字是多少？	我不知道，我没看过。	0
你为什么喜欢看恐怖小说？	我也不知道，就是喜欢看。	0
嗨，你好呀，今天来上学了吗？	是啊，今天上了一天的课!	0
哼	我觉得很不错啊,你不喜欢吗?	0
真幸福，你是做什么劳作的？	没什么啊,就是在网上卖点衣服	0
你读过的书中有哪一本？	活着，活着，平凡的世界，活着	0
你得到了什么样的实习机会？	自己找的,一个月500	0
你带了多少辆自行车？	你怎么知道?就一辆啊	0
你推广游戏有多少年了？	那现在还在做推广工作吗?	0
那你呢？你喜欢面条吗？	我不喜欢吃面条!	0
我最喜欢的歌是什么？	我也不知道，你喜欢听什么歌？	0
那你真的很无聊。你有孩子吗？	没有,你呢,结婚了吗?	0
你厌烦写小说吗？	不厌烦	0
我在开玩笑。狗不会被扔掉。你必须保留它们。你什么时候结婚的？	我还没结婚呢，只是订婚了!	0
嗨	我是商丘的哦	0
你一定要担心天气吗？	我是觉得天气不好练瑜伽不太舒服	0
你什么时候进来的？	我也是刚进来的，你是做什么的？	0
我喜欢打排球或去健身房。你通常喜欢做什么？	打球，看书，打球，打球	0
现在最流行的吃家鸡啊，你喜欢玩游戏吗？	不喜欢!	0
是的，你的家人呢？	都在这边呢,你呢?	0
你每天锻炼吗？	以前锻炼,现在上班了没时间练了	0
他在哪？	北京。	0
你不会还在放工吧？	没有了,已经回家了	0
你知道谁是我最喜欢的明星吗？	你喜欢王嘉尔,我不知道啊	1
你有什么好计划吗？	没有，你有吗？	0
开网店要花多少钱？	我是加盟做的,比较便宜一点,三四千块钱吧	0
你最厌恶的电影是什么？	我最讨厌的是《放牛班春天》	0
你知道贵阳在哪里吗？	贵州省贵州市你不知道吗?	1
你工作多久了？	两年多了,你呢	0
你第一次去那里是什么时候？	就是这次啊	0
你多大了？	我今年刚满十八岁。	0
你知道我喜欢听谁的歌吗？	不知道呀,说嘛	0
啊哦	你好，请问你是做什么工作的？	0
员工们每天几点上班？	八点上班,下午五点下班,中午两个小时吃饭	0
你做什么运动？	跑步、游泳、跳绳、跳绳	0
你知道我来自中国的哪个方向吗？	我不知道,你知道么	0
我来自武汉。你不去上班吗？	我在家,你多大了	0
你有不同的工作时间吗？	嗯,我有一天早班一天晚班	0
你工作多久了？	我工作两年了，现在在一家外企上班。	0
你一定很年轻吧？	不年轻了,我也25了	0
嗨嗨	你也有这个病啊	0
你知道我妈妈说什么语言吗？	不知道，没听过。	0
是的，你是哪里人？	哇,好遥远,我是福建的	0
你是哪里人？	我是河北邯郸人	0
你知道我什么时候开始上大学的吗？	我不知道,你告诉我吧	0
我之前也试着种过花，可是最后都没活下来，你是有什么门路吗？	我是没有门路的!	0
您好，你觉得这个东方明珠怎么样？	我觉得还可以啊!挺好看的!	0
你的身体能忍受吗？	能啊，这个问题问得好!	0
是	你有什么事吗？	0
你通常什么时候去？	晚上啊，有时候晚上都会去	0
你吃了多少面包？	两个,还有一杯牛奶,一杯豆浆	0
啊好	你知道吗，我很喜欢你的车	0
你知道我最喜欢的节日是什么吗？	我不知道,但我希望是一个能和心爱的人一起度过的节日	0
她瘦了多少磅？	5磅左右吧，我也不知道!	0
程序员，你没有和同事们玩游戏来放松吗？	没有，我都是和同事一起玩的	1
你不想旅行吗？	想啊,就是没有想去的地方呢	0
肖的昵称是什么？	我不是他什么人,我是他粉丝	0
你知道我最喜欢吃什么样的快餐吗？	不知道，我也不知道!	0
那你家里有养小植物吗？	有啊,我的植物都快被我养死了	0
嗯？	你现在在哪做金融?	0
你的家人叫什么名字？	我家没有家人，只有我爸和我妈!	1
哦~	你还演过我吗?	0
你知道一周有多少天我必须站在门口迎接顾客吗？	不知道!	0
一个学生每月挣多少钱？	我做的加盟网店呀,一月也能挣个三四千吧	0
嗯，我上网看看。顺便问一下，你研究过汽车吗？	研究过,也买过	0
你来自哪个地区？	我是广东省茂名市的	0
你知道我喜欢听什么书吗？	不知道,不过应该不是我喜欢的类型	0
嘻哈	我是一个喜欢聊天的人	0
别这么说。跟我说说你。你通常喜欢做什么？	我也没什么,就是开了个,网,店,一个,月,赚,个,三,千多块	0
你多大了？	我也是22岁,我在上大学	0
你也厌烦旅游吗？	不厌烦啊	0
你知道我在哪里学习吗？	不知道啊!你是哪个省的？	0
那你现在餐厅每天都闲吗？	不闲,有客人就忙	0
你什么时候毕业的？	我是去年毕业的,那你今年是不是应该实习了?	0
哦哦	嗯,你是哪里人?	0
我再看书呢，你看的什么影片呀？	我看的是《放牛班的春天》	0
好呀	学姐，我想和你交个朋友	0
你这么忙干什么？	忙着找工作啊!	0
那你最厌恶看那个种类的电影呢？	我不喜欢看恐怖片	0
那孩子小时候很淘气。你不喜欢吗？	我喜欢调皮的小孩!	0
有多少人？	两只，一公一母，还有一只母的	1
哦哦嗯	猜不对,那告诉我吧	0
你知道我看的视频叫什么名字吗？	不知道!	0
那你应该有高收入？	嗯啊,还好吧,够我自己花了	0
就叫我王明吧。你不是青岛人吗？	我是山东人，在青岛工作。	0
你知道我为哪个队效力吗？	中国人民解放军?	0
你知道我来自哪个城市吗？	不知道啊，你是哪里的？	0
你知道我最喜欢的乐队是什么吗？	不知道,我喜欢的是五月天的温柔	0
你为啥要学法规呀？	因为喜欢，所以学!	0
你这么忙干什么？	销售就是这样的，忙的时候忙死，闲的时候闲死!	0
没什么，你是做什么劳作的？	什么都没干,在家呢	0
你知道谁是最富有的人吗？	我知道,他叫马云	0
我妈妈什么时候不在家？	你妈妈啥时候都在家	0
我刚找到一份新工作。你呢？	我在广州，你是做什么的？	0
你知道谁又帅又绅士吗？	不知道!	0
你有多少首最喜欢的歌？	不知道，我只是喜欢听而已。	0
就这个原故吗？	当然，还有另外的原因。	1
我很少吃奶酪。顺便问一下，你知道蚱蜢能吃吗？	我不知道啊!我也很少吃啊!	0
你不拍什么样的照片？	都拍啊	0
火车什么时候到？	下午两点多，你呢？	0
谁模仿得好？	朱亚文啊!	0
你知道我多大了吗？	14岁不是初中吗	0
你知道一周中的哪一天我要和朋友去卡拉OK吗？	不知道啊!	0
你不喜欢什么小动物？	不喜欢猫,其他的都喜欢	0
你厌恶什么极限运动呢？	不喜欢，只是不喜欢而已。	0
好哇	你在干嘛呢？	0
呜	你怎么了,我在吃麻辣烫	0
你家有几个孩子？	两个，一个妹妹，一个弟弟!	0
我现在是一家超市的总经理。你有什么爱好吗？	我喜欢逛超市，买衣服，买鞋子，买包包。	0
我希望住在哪里？	你想住哪里	0
懒汉，你不觉得无聊吗？	你不知道,我很忙,很烦,很累吗?	0
你在哪？	我在拉萨啊	0
你商店的月收入是多少？	小店是什么小店呀,可以交,交我吗?	0
啊哈哈	你在干嘛呢？	0
我们换个话题吧。你喜欢运动吗？	羽毛球,游泳,乒乓球,足球	0
你好，我也是。你现在在做什么？	我在一家小公司上班，还没找到合适的工作!	1
你好，你能和我联系一下吗？	可以啊!你想聊些什么呢？	0
你什么时候上班？	明天上午啊，你在干嘛呢？	0
你喜欢比较宁静的地区，那你平时都会干些什么？	看书,看电影,听音乐	0
胃痛吗？	不是,肚子疼	0
唉	我也是，不过我都是自己练的。	0
你有多少首最喜欢的歌？	很多啊，你想听哪首？	0
你有什么动物？	我养了一只小哈!	0
我通常读什么书？	你喜欢看什么类型的书？	0
嘤嘤嘤	我报的都是省内	0
你想去哪里？	我也不知道,我想做一个小会计,有发展前途的那种	0
你现在是做什么劳作呢？	我现在做人力资源管理,你做的事哪行?	0
你没见过河南洛阳的牡丹吗？	没有，只知道牡丹花会。	0
哦，你业余时间喜欢做什么？	发呆，看书，睡觉，打豆豆。	0
你知道我什么时候喜欢学摩托车吗？	不晓得,你喜欢摩托车?	0
这是你的特别喜好吗？	我不知道，我只知道我喜欢你	0
是的，你有工作吗？	有啊，怎么了？	0
你已经学习了多少年了？	断断续续的，最近才开始的。	0
你这是怎么了，怎么这么欢乐呢？	我也不知道，就是突然想起来了。	0
我也不喜欢。你有喜欢的吗？	有!但是我不喜欢吃!	1
你打算什么时候做？	明年啊,你呢	0
你知道我把父母带到哪里去了吗？	不知道诶,你跟我说一下嘛?	0
呦呵	你呢?你也喜欢跑步?	0
我也喜欢看书，你讨厌看哪种类型的？	我讨厌看那种太长的,还有太无聊的书	0
好的，你喜欢吃甜的还是酸度的呀？	甜度的,酸酸甜甜的,我是不是有点变态了	0
没关系。看一看，练习一下你的勇气。今天不是周末。你今天打算做什么？	我打算看恐怖片	0
你知道你见过这些生物吗吗？	没有,只是在网上了解了一些	0
达利在哪里？	达利是啥?	0
我在看综艺节目。我最近爱上了一个叫《快乐喜剧演员》的综艺节目。你看不出来吗？	我看出来了,但是我不说	0
你的父母来自中国东北吗？	不是,来自山东临沂	0
你知道711的号码是多少吗？	我不知道,我知道你说的是便利店的号码吧	0
谁创造了小红帽？	就是郑多燕的那个减肥操,小红帽	0
你有几个兄弟？	我有三个弟弟，一个妹妹。	0
别担心钱。这不是主要为了好玩吗？	我只是问问要多少钱才能去,我又没说我要去	0
你知道我喜欢看谁的电影版《爱丽丝梦游仙境》吗？	你可以告诉我吗?	0
这张照片是什么时候拍的？	去年7月份	0
你知道我在哪里工作吗？	我不知道，你告诉我吧!	0
你知道我什么时候开始踢足球吗？	你是不是从5岁的时候就开始踢球了	0
你好，你是哪儿人氏？	我是安徽人,我现在在南京	0
我在看探险剧目，你是做什么劳作的？	我是一个摄影爱好者，很高兴认识你!	0
你看过多少科幻电影？	我看的不多,但是也挺喜欢的,我比较喜欢魔幻片	0
看来你们很相爱。你有孩子吗？	是啊,你也会很幸福的,我还没结婚	1
我最近很开心。你知道为什么吗？	因为你有男朋友了!	0
噢	我也是,我准备过几天去	0
你的脚踏车很好看啊，新买的吗？	是的，新买了一辆。	0
是的，你吃早餐了吗？	还没,还在路上,估计到公司都九点了	0
和你聊天要花多少钱？	不要钱,但是,你得给我钱	1
哎哎哎	那你喜欢什么运动呢?	0
我有多少只猫？	两只啊,你自己都说了	0
高中三年级是哪一年？	我也是三年级，你哪个班的？	0
啊啊	啊啊是什么意思	0
哦~	哦、那你上高几了?	0
你说得对。你是做什么的？	我是做服装的，现在在一家外贸公司上班!	0
。	大妈,你是不是还没对象啊	0
你多大了？	我也二十,你是哪里的?	0
你知道我在哪里学习吗？	你不是说你在郑州吗	0
你知道我更喜欢听什么吗？	不知道!	0
对哎	那你现在在做什么工作呢？	0
我更喜欢什么季节？	夏天，冬天太冷了!	0
你知道3号床的儿子的病房号是多少吗？	不知道哎,我只知道我们的	1
律师在哪？	北京啊，你在北京吗？	0
那你最讨厌的故事是什么呀？	没有,你要听么?	0
你知道我多大了吗？	不知道，你告诉我吧!	0
那真巧，你在哪里劳作呢？	在北京啊，你也在北京吗？	0
哇哦	你也可以尝试一下	0
你知道歌中有什么动物吗？	黑豹和郝云	0
你也喜欢看乒乓球吗？	是的,非常喜欢	0
是的，你为什么难过？	因为我觉得我不应该有这样的生活	0
是不是玩耍挺好的呀？	嗯嗯,挺会玩的	0
啊，你明白。你还是学生吗？	我不是啊!我已经工作了	0
现在很晚了。你吃过晚饭了吗？	我还没吃,刚到家	0
季后赛第二轮的名字是什么？	季后赛是什么我真的不知道	0
那你为什么选择这个职业呢？	因为喜欢，所以选择。	0
额	你玩什么游戏呀	0
你知道我有几个女儿吗？	不知道，我只知道你有两个儿子	0
你是北方人吗？	我是南方人，在北方上学!	0
那你呢？你喜欢什么？	我也不知道我喜欢什么,我觉得现在的我很迷茫	0
你过活挺丰富的嘛，你劳作了吗？	我一直在工作啊，没有劳作啊!	1
你开什么类型的车？	我开福特福克斯，这是我的第一辆车	0
别人捡到了什么？	捡的是小土狗	0
那你一定很讨厌看书喽？	是的，不喜欢!	0
我来自济南。你不需要工作吗？	我不需要啊,在家里,你呢	0
啊，你父母是做什么的？	我爸是建筑师，我爸在建筑公司上班。	0
你经常去当献血者吗？	是的，每个月都去。	0
你知道我喜欢什么节日吗？	我不知道，我也不知道!	0
对吗	我是吃不了多少辣,但就是喜欢吃,我在家里都是我做的	0
那我就跟你谈谈。这会阻止你染发吗？	那你说吧,我听你说	0
你好呀，你是放工了吗？	是的，今天休息，明天开始上班!	0
有多少只仓鼠？	还有一个死了的,现在有三个	0
你多大了？	比你大，比你大!	0
那你呢？你通常不喜欢做什么？	我不喜欢上班,不喜欢跟人打交道	0
你这么认为吗？	是的,我是男的,我也不知道为什么	0
当然，我每天游泳几个小时。你每天游泳吗？	我每天晚上都去游的!	0
你大概有多高？	一米七三左右吧，你呢？	0
你能给我一个机会吗？	我能说我不想谈恋爱么?	0
行啊，你是做什么劳作啊？	我也在找,没找到	0
好的，你通常喜欢做什么？	看你问的这么仔细我都想跟你交朋友了	0
哦哦嗯	你在哪里工作啊?我在上海	0
你几岁了？	我26了。你呢？	0
她不知道你喜欢她吗？	我不知道她知不知道我喜欢她	0
那你有厌烦的乐队吗？	没有，我只是喜欢听音乐而已。	0
是啊，难道你不是一个未婚人士吗？	我已婚啊,所以我说我不想结婚啊,我又没说未婚的不想结婚啊	0
你知道我开始演戏的时候多大了吗？	我不知道,不过我现在18,我是12岁开始演的	0
太好了。你是在网上买的吗？	是的,买了好几年了	0
哈咯啊	你要过生日了吗	0
你怎么知道水很冷？你下水了吗？	我不下水，因为我是旱鸭子!	0
必须澄清误解。你现在还在那里工作吗？	是啊，我在这里上班啊!	0
和你在一起的那个人几岁？	他比我小一岁	0
你放工很早吗？	不早了，最近比较忙	0
你知道我有几个孩子吗？	你不是说了两个吗?	0
能和你交个友人吗？	什么是友人?	0
你知道一个三十岁的男人应该是什么样的人吗？	不知道，我也不知道	0
那你讨厌看什么类型的电视剧呢？	悬疑的，破案的都不喜欢!	0
现在还早。你是做什么的？	学生啊!你呢？在哪个学校？	0
你知道我能说多少种语言吗？	不知道，只知道你能说很多语言。	0
你去过摇滚乐现场吗？	没有啊,我也是学生党啊	0
你知道我喜欢在哪个城市骑车吗？	不知道,但我知道我想去的地方有自行车	0
你知道什么是关于动物的书吗？	不知道,我只看了一本,叫动物庄园	1
那你身边的友人一定也和你有相同的爱好吧？	嗯嗯,有的,而且都是我很好的朋友	0
你是不是很讨厌旅游啊？	我也喜欢旅游,不过我更喜欢自己一个人去	0
好吧，那你岂不是每天都很有趣？	是啊，有趣的灵魂万里挑一!	0
你忙着学习吗？	没有,我也不爱学习,我是学渣	0
除了烹饪，你还有什么爱好吗？	除了做菜，其他的都可以啊!	0
有多少年了？	4年多了，你家的是公的还是母的？	0
你以前试过减肥技巧吗？	试过的,不过没坚持下来就是了	0
我没有午睡的习惯，你是一个厌恶午睡的人？	那倒不是,只是不喜欢被人吵醒	0
你是一个很有雄心的人物，那你住员工公寓楼吗？	住啊，怎么了？	0
嗯嗯，听你说的这么有道理，你是也厌恶读书吗？	我不讨厌读书，只是不喜欢那些书!	0
哼	你怎么知道我在找你？	0
你知道我住在哪里吗？	不知道。	0
我现在住在哪里？	我怎么知道你住哪?	0
你知道我最喜欢的季节是什么吗？	我不知道，我只知道我喜欢夏天!	0
喔唷	然后我也喜欢钓鱼	0
你知道我去哪里卖椰子吗？	不知道，你告诉我吧!	0
你在做什么？	还没找到呢,现在还在家,明天去面试	0
你的劳作一直需要用电脑吗？	不是,偶尔	0
我现在最大的爱好就是摄影和徒步旅行，你讨厌吗？	不讨厌，挺好的!	0
那你很厉害哦，你平时也讨厌运动吗？	不讨厌!只是不喜欢!	0
你知道我儿子多大了吗？	不知道，我只知道他是我儿子。	0
你知道我喜欢谁吗？	你喜欢的人是谁？	0
你厌烦看谁的电影啊？	我不喜欢看电影，我喜欢听音乐。	0
你知道我最喜欢的乐队是什么吗？	不知道!	0
我能听你说话吗？	可以啊，你想听什么？	0
我去哪里旅行了？	你不是在丽江吗？	0
你知道我在哪里工作吗？	不知道，你在北京哪儿？	0
你知道我多大了吗？	不是12岁吗	0
你喜欢糖吗？	我不喜欢吃甜食	0
服务员，你一定不会因为工作累吧？	当然不会，我很喜欢这份工作。	0
你多大了？	我今年刚满十八岁，你应该比我大吧？	0
你结婚有多少年了？	我还没结婚,现在是我男朋友	0
那你一定是个女孩？	我不是女孩难道是男生?	0
你还没找到吗？	你在哪里,我可以帮你看看	0
谢谢啊，你是小姐姐还是大哥哥啊？	我是你大姐姐哦,我都20几岁的人了	0
姐姐，你工作的薪水是多少？	我也不知道，没问。	0
你知道我教几年级吗？	六年级的,对不	0
是的，你现在主修什么？	我现在在学商务英语，你呢	0
我喜欢火锅。我觉得很好。你怎么认为？	嗯,我也喜欢,就是人太多了,要早点去才行,不然没位子了就	0
你在哪里教书？	我是西关初中,不过我不想干了	0
你多大了？	比你小一岁，你应该比我大吧？	0
你好呀，你是毕业生还是女生呢？	我是男的，毕业生!	0
我每年都去看什么？	你每年都去看什么?你是上海的吗	0
雪佛兰汽车，那你平时厌恶做什么呢？	就是不知道自己厌恶的是什么,所以就不知道该怎么做了	0
你喜欢什么样的音乐？	我不懂音乐,但是我喜欢听	0
你很讨厌打乒乓球吗？	不讨厌，只是不喜欢而已!	0
你和家人住在一起吗？	是啊,从小到大都在一起	0
我高中毕业了。你不喜欢什么？	不喜欢的太多!	0
好哦	你是什么学校的啊?你学的什么专业啊?	0
、	怎么了,有什么问题吗	0
小桂的真名是什么？	真名就叫小桂	0
你知道我教几年级吗？	我觉得应该是初一吧	0
我也喜欢看篮球比赛。你看NBA吗？	不看，我不喜欢看球赛!	0
你工作这么闲的吗？	我在家里工作,所以比较闲	0
欸	你是做什么的？	0
所以你现在应该伤心了？	我觉得我是不是有病,为什么要这样对待一个喜欢我的人	0
和你在一起的那个男人几岁？	我不知道，我只知道他比我大四岁。	1
你父亲是演员吗？	不是,他就是普通的军人	0
你在读哪所大学？	武汉工程大学,你呢	0
平常的劳作也很轻松，你呢，你是做什么事情的？	我在家带宝宝,没事的时候就看下电视剧,做下网店	0
你也喜欢听音乐吗？	嗯嗯，喜欢听他的歌	0
我是哪里人？	河南的，你呢？	0
我有多少独立的设计室？	不知道,反正我知道有很多独立设计室	0
你知道我开始演戏的时候多大了吗？	我不知道,不过你的演技我是相信的	0
你知道我是哪里人吗？	我的是室外养的	0
你所在的连锁店叫什么名字？	没有连锁店，只有一家分店	0
诶呀	我也有过三个老公,但是都不太好,所以现在老公对我很好	0
我一听说你喜欢购物，我猜你是个女孩？	我也不喜欢逛街	0
嗯，我喜欢玩游戏，你厌烦做运动吗？	嗯,运动我也喜欢,不过不喜欢剧烈的	0
喔唷	你是不是比我小哦?	0
我喜欢哪个国家的动漫？	这个我可不知道,你自己心里最清楚	0
北京的城市在哪里？	在中国,在地球,在亚洲	0
你在博物馆工作，喜欢读书，你有很多朋友？	嗯，还好吧。	0
你告诉他名字了吗？	他问过我	0
他也是个任性的男孩。你没有喜欢的人吗？	有啊,他也有女朋友的	0
谁的相声很好？	郭麒麟,岳云鹏,单田芳,单老	0
可以啊，我是一名学习者，你呢？	我也是,学习使我快乐	0
你知道我多大了吗？	不知道,反正你比我大	0
你听过多少首歌？	也没多少,听过的都是经典老歌,他们的新歌我不喜欢听	0
我不太喜欢打篮球，你喜欢看影片吗？	我也喜欢电影,但最近电影都不好看	0
教堂位于城市的哪个区域？	东区，我住在东区。	0
你什么时候去机场？	我在机场上班,我不去机场,是帮朋友拿东西	0
你是演员吗？	不是,你要做演员?	0
你没看过关于滑板的节目吗？	没看过!但是我知道有这个节目!	0
你多大了？	我是89年的，你呢	0
你拍了多少张照片？	我只拍了一张	0
哇，那你画图肯定很厉害了？	没有啦，只是爱好而已	0
你知道我有几个孩子吗？	不知道,你告诉我啊	0
你知道我是哪里人吗？	你也合肥啊	0
你好，朋友。今天过的怎么样？	我不太好你呢	0
我不怎么看闲书，你有什么好看的闲书推荐吗？	我也不知道啊，最近都没怎么看书	0
没问题，你喜欢《天堂电影室》这部影片吗？	当然喜欢，这是我最喜欢的一部电影!	0
谁是流行歌手？	周杰伦算是吧	0
噢噢噢	你知道吗，我很喜欢你	0
我买了一些银首饰。我特别喜欢银首饰。重点是我只能带银首饰。你在淘宝上买了什么？	衣服啊,饰品之类的吧	0
你知道我有多少只海龟吗？	不知道!	0
你能找到工作吗？	我还没毕业呢，怎么找工作啊!	0
你现在还在和你妈妈做手工艺品吗？	没有,我在老家做,家里的手工不挣钱,我想在家门口找个手工活	0
你通常喜欢运动吗？	不喜欢，只是喜欢和朋友一起打球!	1
你多大了？	我今年24岁了。	0
你也讨厌花花吗？	我不讨厌啊,我喜欢他的歌,很好听	0
北京所在地区的名称是什么？	我说不清楚,你可以百度	0
你在哪里能买到房子？	上海啊，我也不知道哪里可以买到	1
但是你不觉得下雨很酷吗？	我喜欢下雨的时候看书，听雨声!	0
嗨嗨	嗨，你好!	0
你知道我是哪个城市的人吗？	你说你是北京人的	0
是啊，你讨厌购物吗？	还行吧,我喜欢网购,你是做网店的吗?	0
你最近在看谁？	张嘉佳的,从你的全世界路过	0
你喜欢什么样的天气？	我喜欢冬天，夏天太热了!	0
你知道我30岁是哪一年吗？	不知道，你说说看!	0
你就读的大学叫什么名字？	我就读的学校叫北京大学，我的成绩也很好。	0
你知道现在是几月吗？	现在是4月了	0
那你一定身体不好吧？	我身体很好，只是不喜欢运动而已!	0
你现在在哪里？	我在北京啊，你呢	0
你有小动物吗？	有啊，都是我养的!	0
大白的颜色是什么？	白的,纯白	0
你喜欢摇滚乐？	喜欢啊,你要给我介绍?	0
你好，你在学校还是在工作？	学校啊,你也是大二?	0
嗯嗯，你教的是哪门语言呀？	我教的是英语和法语。	0
你喜欢什么样的天气？	我喜欢下雪的天气!	0
哎呦	哎呦什么，你不是在上班么？	0
嘤嘤	我是学渣,所以毕业工作了	0
你来自哪个省？	我来自广东，你在哪个省呢？	0
好的，你很讨厌打排球吗？	你说的打排球是什么意思?	0
你在咖啡馆工作吗？	是啊在西直门	0
嗯嗯嗯	你在哪个城市呢？	0
？	怎么啦,你呢	0
嘁	那是在哪儿啊	0
我忍不住要表扬你。你为什么这么好？你为什么不做翻译呢？	因为我不喜欢做翻译啊	0
你什么时候去公司开会的？	早上八点,你呢?	0
你想赢多少钱？	我想中一千万!	0
喝啊	是不是很好听呢?	0
太好了。既然你这么喜欢爵士乐，你学过爵士乐吗？	没有，只是对音乐比较有兴趣。	0
你喜欢哪个国家？	没有特别喜欢的国家	0
你什么时候回去？	明天下午的车，后天早上到!	0
你喜欢哪个城市？	青岛的海边城市都喜欢。	0
王力宏最喜欢的歌手是谁？	王力宏不是喜欢陈奕迅么?我觉得是,他也说了,他和他偶像关系好	0
那很好。你是做什么的？	我现在做的是房地产,你呢?	0
太好了。你一个人吗？	是的啊,我一个人去的	0
你知道谁的歌真的很好吗？	不知道，我只知道他的歌很好听!	1
你失业了吗？	我已经失业半年了	0
哦哦，我也挺喜欢听音乐的，那你是做什么劳作的呀？	我是学生,我开了个网店,我叫梦梦,很高兴认识你	0
你知道我特别喜欢哪个魔术师吗？	是不是约翰逊?	0
那你都是怎么打发日子的呀？	玩游戏,看书,看视频	0
你知道什么时候很忙吗？	我不知道,我是新人,求罩	0
你知道我上的是什么样的大学吗？	不知道，我只知道你是学姐!	0
是的，你还没起床吗？	我已经起床了，你呢？	0
这是编辑的基本要求。嘿，你不工作的时候做什么？	写稿子，写文章，写新闻稿子。	0
真遗憾。你现在在做什么？	我现在做的是行政助理，也是文员。	0
你是哪里人？	我是河北人,你多大了?	0
你知道我喜欢谁的音乐吗？	不知道，你说说看!	0
听了多少遍了？	第三遍有了,就记得这几句歌词了	0
你多大了？	我今年23岁了，你应该比我大吧？	0
住在城市里的人的年龄范围是多少？	不知道啊，我也不知道。	0
你知道我所在的树叫什么名字吗？	不知道,难道我就是你要找的人?	0
是的，周末休息一天比你少一点，不是吗？	一个星期两天,你比我多	0
她不知道你要离婚了吗？	她知道我有这想法,她一直劝我不要离	0
你为什么这么说？你也学医吗？	不是，我是学西医的。	1
你知道这本书的评论员是什么吗？	不知道	0
我讨厌什么季节？	冬天啊，春天啊，秋天啊，冬天啊	0
我准备出去吃饭呢，你讨厌吃什么呀？	我不喜欢吃辣的!	0
你知道什么时候有人邀请我出来的吗？	什么时候,我不知道	0
那你一定有很多肌肉吧？	没有，只是喜欢肌肉男而已	0
你早餐吃什么？	我早上就喝一杯牛奶,其他什么都没有吃	0
你很久没写这篇文章了吗？	不是,只是这几天在忙其他东西,没时间写	0
那你现在的劳作一天大概几个钟头？	一个半小时,但是很轻松,基本没人管	0
我什么时候能找到像你这样的工作？	这个我也不知道啊,不过可以去我公司	0
谁是受欢迎的艺术家？	五月天啊	0
嗯对	你呢？有女朋友吗？	0
你的父母是老师啊，我也是老师，不过我是教音乐的，你讨厌音乐吗？	也不是讨厌,只是没时间	0
对呀，你也厌恶养宠物吗？	我没有厌恶呀,只是家里的猫狗实在太多了,养不过来	0
你住在哪里？	我住在徐汇区，你呢	0
喏	你可以教我做啊,我可以做你男朋友	0
你在几年级踢足球？	四年级，不过我已经毕业了。	0
你知道我什么时候去农贸市场吗？	不知道，没去过!	0
咱俩差不多，都挺累的，能看看你拍的著作吗？	我就一个微电影	0
你喜欢去哪里旅行？	喜欢去有山有水的地方,你呢?	0
你不是音乐俱乐部的新成员吗？	我也是音乐协会的成员啊	0
你好呀，放暑假了，准备来哪里玩呢？	不知道啊，想去哪就去哪!	0
你喜欢什么动物？	我喜欢狗，猫，狗，猫!	0
你看过中国四大名著吗？	没有，我只知道四大名着。	0
看看你说我有多粗鲁。我也很精致，好吗？	看样子,你也不知道哪里精致	0
商队有多少钱？	不知道,反正我们没钱	0
你来自中国的哪个地区？	你这问题问得,太有水平,云南昭通	0
你知道我喜欢什么时候骑自行车吗？	不知道，我只知道你喜欢我	0
你通常买什么书？	小说啊,都是买小说的	0
你的老板是房地产行业的大人物吗？	不知道,只知道她是我们公司的头牌,其他不知道	0
你的种族是什么？	汉族的啊,怎么了?难道你不是汉人?	0
你在课堂上做什么？	我在上课啊!	0
哦~	你是男的还是女的？	0
房间里的人有多重？	一个140斤左右,还有一个120斤左右	0
你什么时候去上班？	不知道，还没通知呢!	0
你想上什么样的学校？	我想上卫校啊，可是不知道能上什么学校	0
这很普通。你有自己的房子吗？	有啊，不过还没找到合适的。	1
嘻	看来是结了,恭喜恭喜	0
你知道你往哪个方向漂吗？	我不知道，我只知道我要去北京!	1
可	那你可不可以教教我啊?我是一个小白	0
好的，那你可以换本书了。你有更好的书吗？	我现在在看《心是孤独的猎手》	0
你知道我喜欢走什么吗？	走着,我不知道啊	0
你知道我多大了吗？	不是24吗?难道是我算错了	0
你的爱好不是写小说吗？	不是，我只是爱好而已	1
是的，我真的很怀念学生生活。你主修法律吗？	不是,我学的是计算机	0
你叫什么名字？	艾琳娜.	0
对哦	那你会弹吗？	0
非常感谢。你通常喜欢聊天吗？	我不喜欢跟陌生人聊天。	0
巴耶来自哪个城市？	来自一个遥远的城市	0
你教的是啥专业啊？	你也在学这个?	0
那你都看什么影片啊？	我喜欢看老片子，你呢？	0
你知道我有几个孩子吗？	不知道，我只知道你有一个孩子。	1
你是哪里人？	我是河北人，现在在北京工作!	0
嘻嘻嘻	那你不上班了吗?	0
太好了。你为什么不带？	太远了,家里人不让带,现在在娘家	0
你知道我参加过多少作文比赛吗？	不知道。	0
你好，我可以跟你分享一下我的喜悦情绪吗？	不可以,你是在拉仇恨	0
你知道我是哪个队的运动员吗？	中国队,对吧	0
你想去哪里看文化？	我想去的地方可多了。	0
喜欢啊，我很喜欢我的犬，你吃午饭了吗？	还没呢，正在吃呢!	1
我最喜欢玩王者荣耀，然后就是跟我仅有的两三个友人逛街，你呢？	我现在就在玩,你要一起吗	0
你知道我是哪里人吗？	不知道啊，你是哪里的？	0
好的谢谢你，那你的劳作最近还顺利吗？	还好了,谢谢你	0
你为什么去上班？	因为我是打杂的啊!	0
嘤嘤	你不害怕自己吗?	0
我也对自动驾驶感兴趣。你有什么样的车？	我这里有一台自动泊车，你要吗？	0
是的，我有一只非常可爱的狗。你喜欢狗吗？	喜欢啊!但是我不喜欢狗!	1
你还在上小学。你为什么不在这里学习聊天呢？	聊天不需要学习,你没上过小学?	0
但是你游泳的时候不需要摘下眼镜吗？	我一般不游泳	0
我目前还没有劳作呢，那你呢？	我也还没劳作呢!	0
你买什么衣服？	我买的都是我喜欢的!	0
你是做什么的？	我是做会计的，你觉得呢？	0
你什么时候满20岁的？	我今年才满二十岁，你应该比我大吧？	0
你是自己想学的舞，还是你家人选替你选的？	我学的，我家人都不知道。	0
